Response to organic substance=对有机物质的反应
Response to organic cyclic compound=对有机环状化合物的反应
Response to chemical=化学反应
Cellular response to chemical stimulus=细胞对化学刺激的反应
Cellular response to organic substance=细胞对有机物质的反应
Response to oxygen-containing compound=对含氧化合物的反应
Response to endogenous stimulus=对内源刺激的反应
Response to lipid=对脂质的反应
Response to stimulus=对刺激的反应
Positive regulation of biological process=正向调节细胞对生物过程
Cellular response to organic cyclic compound=细胞对有机环状化合物的反应
Cellular response to oxygen-containing compound=细胞对含氧化合物的反应
Cellular response to stimulus=细胞对刺激的反应
Positive regulation of cellular process=正向调节细胞过程
Regulation of biological quality=调节生物质量
Cellular response to endogenous stimulus=细胞对内源性刺激的反应
Response to hormone=对激素的反应
Response to nitrogen compound=对氮化合物的反应
Response to organonitrogen compound=对有机氮化合物的反应
Response to steroid hormone=对类固醇激素的反应
Response to abiotic stimulus=对非生物刺激的反应
Cell communication=细胞通讯
Signal transduction=信号转导
Signaling=信号
Response to stress=对压力的反应
Positive regulation of metabolic process=正向调节代谢过程
Positive regulation of cellular metabolic process=正向调节细胞代谢过程
Cellular response to lipid=细胞对脂质的反应
Response to ketone=酮反应
Cellular response to organonitrogen compound=细胞对有机氮化合物的反应
Regulation of cell death=调节细胞死亡
Response to external stimulus=应对外部刺激
Cellular response to hormone stimulus=细胞对激素的刺激做出反应
Regulation of cell population proliferation=调节细胞增殖
Regulation of response to stress=调节应激
Regulation of localization=调控定位
Regulation of apoptotic process=调节凋亡过程
Regulation of response to stimulus=调节对刺激的反应
Regulation of multicellular organismal process=调节多细胞的生物过程
Positive regulation of response to stimulus=正向调节刺激反应
Regulation of developmental process=调节发展过程
Positive regulation of nitrogen compound metabolic process=正向调节氮化合物代谢过程
Response to inorganic substance=无机物质反应
Cell surface receptor signaling pathway=细胞表面受体信号通路
Multicellular organismal process=多细胞的生物过程
Response to oxygen levels=对氧含量的反应
Response to hypoxia=对缺氧的反应
Positive regulation of macromolecule metabolic process=正向调节大分子代谢过程
Positive regulation of multicellular organismal process=正向调节多细胞生物过程
Metabolic process=代谢过程
Negative regulation of cellular process=负向调控细胞过程
Intracellular signal transduction=细胞内信号转导
Regulation of cell differentiation=调节细胞分化
Negative regulation of biological process=负向调控生物过程
Cellular response to chemical stress=细胞对化学胁迫的反应
Biological regulation=生物调节
Positive regulation of gene expression=正向调节基因表达
Regulation of signal transduction=调节信号转导
Regulation of cell communication=调节细胞通讯
Regulation of signaling=信号调节
Cellular response to stress=细胞对压力的反应
Organic substance metabolic process=有机物质代谢过程
Regulation of biological process=调节生物过程
Response to metal ion=金属离子反应
Regulation of transport=调节运输
Response to extracellular stimulus=对细胞外的刺激做出反应
Negative regulation of cell death=负调控细胞死亡
Positive regulation of signal transduction=正向调节信号转导
Regulation of cellular metabolic process=调节细胞的代谢过程
Negative regulation of apoptotic process=负向调控凋亡
Regulation of cellular process=调节细胞的过程
Response to cytokine=对细胞因子的反应
Regulation of body fluid levels=调节体液水平
Positive regulation of biosynthetic process=正向调节生物合成过程
Regulation of intracellular signal transduction=调节细胞内信号转导
Regulation of metabolic process=调节代谢过程
Cellular response to steroid hormone stimulus=细胞对类固醇激素刺激的反应
Positive regulation of cellular biosynthetic process=正向调节细胞生物合成的过程
Regulation of primary metabolic process=调节主要代谢过程
Positive regulation of molecular function=正向调节分子功能
Nitrogen compound metabolic process=含氮化合物的代谢过程
Regulation of molecular function=调节分子的功能
Primary metabolic process=主要代谢过程
Response to alcohol=对酒精的反应
Positive regulation of cell death=正向调节细胞死亡
Response to nutrient levels=应对营养水平
Intracellular receptor signaling pathway=胞内受体信号通路
Negative regulation of response to stimulus=应激的负反馈
Organonitrogen compound metabolic process=含氮有机化合物的代谢过程
Homeostatic process=自我平衡的过程
Negative regulation of cell communication=负向调控细胞通信
Response to radiation=对辐射的反应
Negative regulation of signaling=负向调控信号
Positive regulation of protein metabolic process=正向调节蛋白质代谢过程
Positive regulation of transcription by rna polymerase ii=负向调控rna聚合酶ii转录
Response to oxidative stress=氧化应激反应
Regulation of reactive oxygen species metabolic process=调节活性氧代谢过程
Regulation of biosynthetic process=调节生物合成的过程
Cellular process=细胞过程
Cellular response to external stimulus=对外部刺激的细胞反应
Apoptotic process=凋亡过程
Response to nutrient=对营养的反应
Regulation of multicellular organismal development=调节多细胞有机体的发展
Cellular response to abiotic stimulus=非生物刺激的细胞反应
Response to reactive oxygen species=对活性氧的反应
Response to corticosteroid=对皮质类固醇的反应
Regulation of response to external stimulus=调控对外部刺激的反应
Cell death=细胞死亡
Cellular response to oxidative stress=细胞对氧化应激的反应
Response to peptide=对肽的反应
Response to estradiol=对雌二醇的反应
Response to mechanical stimulus=对机械刺激的反应
Positive regulation of transcription, dna-templated=正向调节DNA模板转录
Chemical homeostasis=化学体内平衡
Negative regulation of developmental process=负调节发育过程
Cellular response to xenobiotic stimulus=细胞对异种刺激的反应
Negative regulation of cell differentiation=负调节细胞分化
Response to light stimulus=对光刺激的反应
Positive regulation of transport=正向调节运输
System process=系统进程
Regulation of small molecule metabolic process=调控小分子代谢过程
Cellular response to cytokine stimulus=细胞对细胞因子刺激的反应
Response to lipopolysaccharide=对脂多糖的反应
Positive regulation of developmental process=正向调节发展过程
Gland development=腺体发育
Regulation of transcription by rna polymerase ii=rna聚合酶ii转录的调控
Developmental process=发展过程
Regulation of locomotion=运动调节
Positive regulation of intracellular signal transduction=正向调节细胞内信号转导
Lipid metabolic process=脂质代谢过程
Regulation of lipid metabolic process=调节脂质代谢过程
Positive regulation of nucleobase-containing compound metabolic process=正向调节含核苷酸的化合物代谢过程
Cellular response to reactive oxygen species=细胞活性氧反应
Negative regulation of signal transduction=负调节信号转导
Positive regulation of rna metabolic process=正向调节rna代谢过程
Regulation of immune system process=调节免疫系统的过程
Animal organ development=动物器官的发展
Cellular response to peptide=肽细胞反应
System development=系统开发
Positive regulation of apoptotic process=正向调控凋亡过程
Chemical synaptic transmission, postsynaptic=化学突触传递,突触后
Regulation of cell motility=调节细胞活性
Negative regulation of cellular metabolic process=负调节细胞代谢过程
Regulation of nitrogen compound metabolic process=调节氮化合物代谢过程
Positive regulation of cellular protein metabolic process=正向调节细胞蛋白质代谢过程
Response to uv=对紫外线的反应
Localization=局部
Positive regulation of macromolecule biosynthetic process=正向调节高分子生物合成的过程
Response to glucocorticoid=对糖皮质激素的反应
Regulation of macromolecule metabolic process=调节高分子代谢过程
Positive regulation of catalytic activity=正向调节催化活性
Regulation of catalytic activity=调节催化活性
Steroid hormone mediated signaling pathway=类固醇激素介导的信号通路
Regulation of apoptotic signaling pathway=调节凋亡信号通路
Organic hydroxy compound metabolic process=有机羟基化合物代谢过程
Cellular developmental process=细胞发育过程
Response to growth factor=对生长因子的反应
Aging=老化
Negative regulation of apoptotic signaling pathway=负调节凋亡信号通路
Response to biotic stimulus=对生物的刺激做出反应
Regulation of protein metabolic process=调节蛋白质代谢过程
Cellular response to ketone=细胞对酮的反应
Establishment of localization=局部化
Transcription initiation from rna polymerase ii promoter=RNA聚合酶II启动子的转录启动
Response to acid chemical=酸的化学反应
Positive regulation of cell cycle=正向调控细胞周期
Response to iron ion=铁离子反应
Response to other organism=对其他生物体的反应
Negative regulation of metabolic process=负调节代谢过程
Response to alkaloid=对生物碱的反应
Regulation of cellular biosynthetic process=调节细胞生物合成的过程
Negative regulation of cell population proliferation=负调控细胞群体增殖
Response to bacterium=对细菌的反应
Positive regulation of protein transport=正向蛋白质运输
Regulation of cysteine-type endopeptidase activity involved in apoptotic process=参与细胞凋亡过程的半胱氨酸型内肽酶活性的调节
Cellular response to oxygen levels=细胞对氧含量的反应
Regulation of hydrolase activity=调节水解酶活性
Cellular metabolic process=细胞代谢过程
Cell differentiation=细胞分化
Regulation of establishment of protein localization=正向调节蛋白质定位
Negative regulation of biosynthetic process=负调节生物合成的过程
Regulation of hormone levels=调节激素水平
Xenobiotic metabolic process=异种生物的代谢过程
Positive regulation of cell population proliferation=正向调控细胞群体增殖
Interspecies interaction between organisms=生物种间相互作用
Cell-cell signaling=细胞间信号转导
Multicellular organism development=多细胞生物的发展
Response to wounding=应对受伤
Reproductive structure development=生殖结构发展
Negative regulation of multicellular organismal process=负调节多细胞生物的过程
Rhythmic process=节律过程
Regulation of protein localization=蛋白质定位的调节
Regulation of cellular protein metabolic process=细胞蛋白质代谢过程的调节
Regulation of gene expression=基因表达的调节
Regulation of cellular component organization=细胞成分组织的调节
Organic cyclic compound metabolic process=有机环状化合物代谢过程
Positive regulation of mitotic cell cycle=有丝分裂细胞周期的正调节
Cytokine-mediated signaling pathway=细胞因子介导的信号通路
Cellular response to growth factor stimulus=细胞对生长因子刺激的反应
Regulation of protein transport=蛋白质转运的调节
Apoptotic signaling pathway=凋亡信号通路
Negative regulation of macrophage derived foam cell differentiation=巨噬细胞源性泡沫细胞分化的负调节
Negative regulation of macromolecule biosynthetic process=大分子生物合成过程的负调节
Anatomical structure development=解剖结构发育
Blood circulation=血液循环
Response to peptide hormone=对肽激素的反应
Regulation of macromolecule biosynthetic process=大分子生物合成过程的调节
Regulation of nucleobase-containing compound metabolic process=含核苷酸的化合物代谢过程的调节
Positive regulation of neuron death=正向调节神经元死亡
Regulation of phosphate metabolic process=磷酸盐代谢过程
Biosynthetic process=生物合成过程
Positive regulation of cell cycle phase transition=正向调节细胞周期相变
Negative regulation of cellular macromolecule biosynthetic process=负向调节细胞大分子生物合成过程
Regulation of cellular macromolecule biosynthetic process=调节细胞大分子生物合成的过程
Regulation of cell adhesion=细胞黏附调节
Cellular biosynthetic process=细胞生物合成过程
Regulation of system process=系统过程调节
Regulation of cell migration=细胞迁移调节
Oxidation-reduction process=氧化还原过程
Negative regulation of nitrogen compound metabolic process=氮化合物代谢过程的负调节
Regulation of macrophage derived foam cell differentiation=巨噬细胞源性泡沫细胞分化的调节
Negative regulation of cellular biosynthetic process=细胞生物合成过程的负调节
Response to toxic substance=对有毒物质的反应
Secretion=分泌
Circulatory system development=循环系统发育
Negative regulation of extrinsic apoptotic signaling pathway=外源性凋亡信号通路的负调节
Regulation of rna metabolic process=RNA代谢过程的调节
Lipid homeostasis=脂质稳态
Regulation of neuron death=神经元死亡的调节
Regulation of cellular response to stress=细胞对应激反应的调节
Negative regulation of macromolecule metabolic process=大分子代谢过程的负调节
Transport=运输
Positive regulation of mitotic cell cycle phase transition=正向调节有丝分裂细胞周期相变
Organic cyclic compound biosynthetic process=有机环化合物生物合成过程
Cellular response to hypoxia=细胞对低氧的反应
Response to amino acid=对氨基酸的反应
Regulation of membrane potential=膜电位的调节
Synaptic transmission, cholinergic=突触传递、胆碱能
Response to drug=对药物的反应
Response to vitamin=对维生素的反应
Macromolecule metabolic process=大分子代谢过程
Cellular response to extracellular stimulus=细胞对细胞外刺激的反应
Transcription, dna-templated=转录，DNA模板
Positive regulation of hydrolase activity=正向调节水解酶活性
Fatty acid biosynthetic process=脂肪酸生物合成过程
Regulation of epithelial cell proliferation=对上皮细胞增殖的调节
Response to hydrogen peroxide=对过氧化氢的反应
Response to purine-containing compound=对含嘌呤化合物的反应
Positive regulation of leukocyte adhesion to vascular endothelial cell=对白细胞与血管内皮细胞黏附的正向调节
Regulation of lipid biosynthetic process=调节脂质生物合成的过程
Tube development=导管发育
Inflammatory response=炎症反应
Monocarboxylic acid metabolic process=单羧酸代谢过程
Regulation of transcription, dna-templated=转录、DNA模板代谢过程
Regulation of blood circulation=血液循环的调节
Positive regulation of cell cycle process=细胞周期过程的正调节
Small molecule metabolic process=小分子代谢过程
Negative regulation of lipid storage=小分子脂质储存过程
Lipid transport=脂质运输
Regulation of extrinsic apoptotic signaling pathway=调节外源性细胞凋亡信号通路
Transcription by rna polymerase ii=RNA聚合酶II转录
Fatty acid derivative metabolic process=脂肪酸衍生物代谢过程
Regulation of inflammatory response=炎症反应的调节
Mammary gland development=乳腺发育
Second-messenger-mediated signaling=第二信使介导的信号传递
Steroid metabolic process=类固醇代谢过程
Protein metabolic process=蛋白质代谢过程
Regulation of catabolic process=分解代谢过程的调节
Regulation of defense response=防御反应的调节
Fatty acid metabolic process=脂肪酸代谢过程
Positive regulation of cellular component organization=对细胞成分组织的正向调节
Negative regulation of transcription by rna polymerase ii=RNA聚合酶II对转录的负调节
Positive regulation of cell motility=对细胞运动的正向调节
Extrinsic apoptotic signaling pathway=外源性凋亡信号通路
Response to tumor necrosis factor=对肿瘤坏死因子的反应
Cellular response to peptide hormone stimulus=细胞对肽激素刺激的反应
Cellular response to hydrogen peroxide=细胞对过氧化氢的反应
Tissue development=组织发育
Positive regulation of reactive oxygen species metabolic process=对活性氧代谢过程的正向调节
Regulation of dna-binding transcription factor activity=DNA结合转录因子活性的调节
Alcohol metabolic process=酒精代谢过程
Unsaturated fatty acid metabolic process=不饱和脂肪酸代谢过程
Wound healing=伤口愈合
Regulation of postsynaptic membrane potential=突触后膜电位的调节
Regulation of wound healing=伤口愈合的调节
Body fluid secretion=体液分泌
Regulation of protein modification process=蛋白质修饰过程的调节
Monocarboxylic acid biosynthetic process=单羧酸生物合成过程
Negative regulation of intracellular signal transduction=细胞内信号转导的负调控
Secondary metabolic process=次生代谢过程
Response to ionizing radiation=对电离辐射的响应
Positive regulation of cholesterol transport=对胆固醇运输的正向调节
Cellular lipid metabolic process=细胞脂代谢过程
Icosanoid metabolic process=类异型代谢过程
Regulation of lipid storage=脂储存的调节
Long-chain fatty acid metabolic process=长链脂肪酸代谢过程
Negative regulation of transcription, dna-templated=转录负调节，DNA模板
Regulation of cellular localization=细胞定位调节
Positive regulation of cell migration=细胞迁移的正调节
Cellular response to metal ion=细胞对金属离子的反应
Regulation of pri-mirna transcription by rna polymerase ii=RNA聚合酶II对pri-miRNA转录的调节
Regulation of lipid localization=调节脂质局部化
Regulation of blood coagulation=调节血液凝固
Synaptic signaling=突触信号
Regulation of sterol transport=调节固醇运输
Positive regulation of vasoconstriction=正向调节血管收缩
Cholesterol homeostasis=胆固醇稳态
Chemical synaptic transmission=化学突触传递
Long-chain fatty acid biosynthetic process=长链脂肪酸生物合成过程
Gonad development=性腺发育
Positive regulation of cellular amide metabolic process=对细胞酰胺代谢过程的正向调节
Response to gamma radiation=伽马辐射反应
Regulation of cell-cell adhesion=对细胞-细胞黏附的调节
Response to ethanol=对乙醇的应答
Positive regulation of cell differentiation=细胞分化的正向调节
Cellular response to fatty acid=细胞对脂肪酸的反应
Regulation of cholesterol metabolic process=细胞对胆固醇代谢过程的的调节
Cell activation=细胞的激活
Sex differentiation=性分化
Negative regulation of molecular function=负调节分子功能
Negative regulation of rna metabolic process=负调节RNA代谢过程
Positive regulation of phosphate metabolic process=正调节磷酸盐代谢过程
Extrinsic apoptotic signaling pathway in absence of ligand=缺乏配体时的外源性细胞凋亡信号通路
Cellular response to alkaloid=细胞对生物碱的反应
Carboxylic acid metabolic process=羧酸代谢过程
Negative regulation of nucleobase-containing compound metabolic process=含核苷酸碱基化合物代谢过程的负调控
Regulation of anatomical structure morphogenesis=解剖结构形态发生的负调节
Regulation of phosphorylation=磷酸化调节
Negative regulation of gene expression=基因表达的负调节
Cellular response to biotic stimulus=细胞对生物刺激的反应
Organic substance biosynthetic process=有机物生物合成过程
Oxoacid metabolic process=氧酸代谢过程
Mammary gland alveolus development=乳腺肺泡发育
Regulation of cell cycle g1/s phase transition=细胞周期G1/s相变的调节
Positive regulation of immune system process=免疫系统过程的正向调节
Positive regulation of response to external stimulus=对外界刺激反应的正向调节
Cellular response to catecholamine stimulus=细胞对儿茶酚胺刺激的反应
Regulation of peptidase activity=多肽酶活性的调节
Regulation of cellular catabolic process=细胞分解代谢过程的调节
Cellular response to amyloid-beta=细胞对淀粉样β蛋白的反应
Regulation of response to dna damage stimulus=细胞对DNA损伤刺激的反应调节
Response to camp=对cAMP的反应
Regulation of cell cycle phase transition=细胞周期相变的调节
Sterol metabolic process=固醇代谢过程
Ovulation cycle=排卵周期
Regulation of smooth muscle cell proliferation=调节平滑肌细胞增殖
Defense response=防御反应
Tube morphogenesis=管状形态发生
Positive regulation of pri-mirna transcription by rna polymerase ii=RNA聚合酶II对pri-miRNA转录的正调控
Cellular aromatic compound metabolic process=细胞芳香化合物代谢过程
Intracellular steroid hormone receptor signaling pathway=细胞内类固醇激素受体信号通路
Heart development=心脏发育
Regulation of muscle system process=肌肉系统过程的调节
Cell surface receptor signaling pathway involved in cell-cell signaling=细胞表面受体信号途径参与细胞-细胞信号传递
Reproductive process=生殖过程
Response to organophosphorus=对有机磷的反应
Digestive system development=消化系统发育
Olefinic compound biosynthetic process=烯烃类化合物生物合成过程
Cellular response to lipopolysaccharide=细胞对内毒素的响应
Heterocycle biosynthetic process=杂环生物合成过程
Regulation of cholesterol biosynthetic process=胆固醇生物合成过程的调控
Regulation of growth=生长调节
Adenylate cyclase-inhibiting g protein-coupled acetylcholine receptor signaling pathway=腺苷环化酶抑制g蛋白偶联的乙酰胆碱受体信号通路
Aromatic compound biosynthetic process=芳香化合物生物合成过程
Organic hydroxy compound transport=有机羟基化合物代谢过程
Olefinic compound metabolic process=烯化合物代谢过程
Nucleobase-containing compound biosynthetic process=含碱基化合物生物合成工艺
Positive regulation of epithelial cell proliferation=上皮细胞增殖的正向调节
Positive regulation of transcription from rna polymerase ii promoter involved in cellular response to chemical stimulus=参与细胞对化学刺激反应的RNA聚合酶II启动子转录的正向调节
Regulation of secretion=分泌调节
Response to progesterone=对孕酮的反应
Hematopoietic or lymphoid organ development=造血或淋巴器官发育
Unsaturated fatty acid biosynthetic process=不饱和脂肪酸生物合成过程
Lactation=哺乳
Retinol metabolic process=视黄醇代谢过程
Neuron apoptotic process=神经元凋亡过程
Regulation of mitochondrion organization=线粒体组织的调节
Female sex differentiation=女性分化
Nervous system process=神经系统过程
Hepoxilin biosynthetic process=海泊西林生物合成过程
Positive regulation of phosphorylation=磷酸化的正向调节
Regulation of angiogenesis=正向调节血管生成
Reactive oxygen species metabolic process=活性氧代谢过程
Positive regulation of protein phosphorylation=蛋白质磷酸化正向调节
Reactive oxygen species biosynthetic process=活性氧生物合成过程
Regulation of protein phosphorylation=蛋白质磷酸化调节
Diterpenoid metabolic process=二萜代谢过程
Regulation of g1/s transition of mitotic cell cycle=有丝分裂细胞周期G1/s转换的调节
Cellular response to mechanical stimulus=细胞对机械刺激的反应
Cellular response to nutrient levels=细胞对营养水平的反应
Cell maturation=细胞成熟
Regulation of cellular protein localization=细胞蛋白定位的调节
Cellular response to dopamine=细胞对多巴胺的反应
Response to nicotine=对尼古丁的反应
Regulation of peptidyl-tyrosine phosphorylation=调节多肽酪氨酸磷酸化
Regulation of cellular response to oxidative stress=细胞对氧化应激的反应的调节
Regulation of leukocyte cell-cell adhesion=细胞对白细胞-细胞黏附的调节
Regulation of oxidative stress-induced intrinsic apoptotic signaling pathway=氧化应激诱导的内在凋亡信号通路的调节
Immune system process=免疫系统过程
Primary alcohol metabolic process=初级酒精代谢过程
Positive regulation of proteolysis=正向调节蛋白分解
Cholesterol metabolic process=胆固醇代谢过程
Regulation of cytokine-mediated signaling pathway=调节细胞因子介导的信号通路
Positive regulation of mitochondrion organization=正向调节线粒体组织
Regulation of steroid metabolic process=调节类固醇代谢过程
Regulation of neuron apoptotic process=调节神经元凋亡过程
Negative regulation of catalytic activity=负调节催化活性
Positive regulation of lipid biosynthetic process=正向调节脂质生物合成过程
Cellular homeostasis=细胞内稳态
Cholesterol transport=胆固醇转运
Positive regulation of dna-binding transcription factor activity=正向调节DNA结合转录因子活性
Detoxification=解毒
Anion transport=阴离子转运
Cellular response to radiation=细胞对辐射的反应
Regulation of cholesterol efflux=调节胆固醇外流
Cellular nitrogen compound biosynthetic process=细胞氮化合物生物合成过程
Regulation of proteolysis=调节蛋白分解
Positive regulation of blood vessel endothelial cell migration=正向调节血管内皮细胞迁移
Ion transport=离子转运
Regulation of mitotic cell cycle=有丝分裂细胞周期的调节
Positive regulation of protein modification process=蛋白质修饰过程的正向调节
Digestive tract development=消化道发育
Regulation of steroid biosynthetic process=类固醇生物合成过程的调节
Adenylate cyclase-modulating g protein-coupled receptor signaling pathway=腺苷环化酶调节g蛋白偶联受体信号通路
Female gonad development=女性性腺发育
Regulation of monooxygenase activity=单加氧酶活性的调节
Macromolecule biosynthetic process=大分子生物合成过程
Regulation of cell cycle process=细胞周期过程的正调节
Positive regulation of cellular protein localization=细胞蛋白质定位的正调节
Regulation of blood vessel endothelial cell migration=血管内皮细胞迁移的调节
Positive regulation of lipid localization=脂质定位的正向调节
Regulation of smooth muscle contraction=调节平滑肌收缩
Response to insulin=对胰岛素的反应
Regulation of blood pressure=血压的调节
Positive regulation of cysteine-type endopeptidase activity involved in apoptotic process=参与细胞凋亡过程的半胱氨酸型内肽酶活性的正向调节
Negative regulation of cell cycle phase transition=细胞周期相变的负调节
Vascular process in circulatory system=循环系统中的血管过程
Regulation of smooth muscle cell migration=血管细胞迁移的调节
Regulation of leukocyte proliferation=白细胞增殖的调节
Cellular response to corticosteroid stimulus=细胞对糖皮质激素刺激的反应
Positive regulation of intracellular protein transport=对细胞内蛋白质运输的正向调节
Regulation of mitotic cell cycle phase transition=有丝分裂细胞周期相变的调节
Developmental process involved in reproduction=参与生殖的发育过程
Response to cadmium ion=对镉离子的反应
Regulation of blood vessel diameter=血管直径的调节
Protein phosphorylation=蛋白质磷酸化
Positive regulation of organelle organization=对细胞器组织的正向调节
Gland morphogenesis=腺体形态发生
Cellular macromolecule metabolic process=细胞大分子代谢过程
Regulation of transferase activity=转移酶活性的调节
Positive regulation of cell adhesion=细胞黏附的正向调节
Regulation of cell development=细胞发育的调节
Regulation of superoxide metabolic process=超氧化物代谢过程的调节
Postsynaptic signal transduction=突触后信号转导
Membrane organization=膜组织
Cellular detoxification=细胞解毒
Enzyme linked receptor protein signaling pathway=酶联受体蛋白信号通路
Serotonin receptor signaling pathway=5-羟色胺受体信号通路
Regulation of cholesterol storage=胆固醇储存的调节
Positive regulation of small molecule metabolic process=正向调节小分子代谢过程
Cellular response to cadmium ion=细胞对镉离子的应答
Cellular response to tumor necrosis factor=细胞对肿瘤坏死因子的应答
Positive regulation of mitochondrial outer membrane permeabilization involved in apoptotic signaling pathway=正向调节参与细胞凋亡信号通路的线粒体外膜通透性
Hemopoiesis=造血
Hormone metabolic process=激素代谢过程
Negative regulation of cell cycle=负向调节细胞周期
Regulation of cell activation=细胞活化调节
Regulation of cell cycle=细胞周期调节
Regulation of mapk cascade=MAPK级联调节
Regulation of oxidative stress-induced cell death=调节氧化应激诱导的细胞死亡
Negative regulation of mitotic cell cycle=负向调节有丝分裂细胞周期
Positive regulation of peptidyl-tyrosine phosphorylation=正向调节肽基酪氨酸磷酸化
Response to thyroglobulin triiodothyronine=对甲状腺球蛋白三碘甲状腺原氨酸的反应
Nitric oxide metabolic process=一氧化氮代谢过程
Prostaglandin metabolic process=前列腺素代谢过程
Positive regulation of peptidase activity=正向调节肽酶活性
Negative regulation of ion transport=负向调节离子转运
Response to interleukin-1=对白介素1的负调节
Negative regulation of extrinsic apoptotic signaling pathway via death domain receptors=通过死亡区域受体负向调节外源性细胞凋亡信号通路
Intrinsic apoptotic signaling pathway=固有的凋亡信号通路
Negative regulation of g1/s transition of mitotic cell cycle=负向调节有丝分裂细胞周期的G1/s过渡
Retinoid metabolic process=类视黄素代谢过程
Positive regulation of lipid metabolic process=正向调节脂类代谢过程
Negative regulation of transport=负向调节转运
Proteolysis=蛋白质分解
Intrinsic apoptotic signaling pathway in response to dna damage=DNA损伤的内在凋亡信号通路
Response to muscle stretch=对肌肉拉伸的反应
Leukocyte migration=白细胞迁移
Morphogenesis of an epithelial fold=上皮褶的形态发生
Response to dexamethasone=对地塞米松的反应
Response to copper ion=对铜离子的反应
Regeneration=再生
Positive regulation of peptidyl-serine phosphorylation=正向调节多肽-丝氨酸磷酸化
Digestion=消化
Glial cell apoptotic process=胶质细胞凋亡过程
Response to estrogen=对雌激素的负向调节
Negative regulation of protein metabolic process=对蛋白质代谢过程的负向调节
Animal organ regeneration=动物器官再生
Regulation of mitochondrial membrane permeability=线粒体膜通透性的调节
Regulation of plasma lipoprotein particle levels=血浆脂蛋白颗粒水平的调节
Positive regulation of cholesterol efflux=胆固醇外流的正向调节
Negative regulation of cell cycle process=负向调节细胞周期进程
Positive regulation of superoxide anion generation=正向调节超氧阴离子生成
Regulation of intracellular protein transport=调节细胞内蛋白质转运
Positive regulation of amyloid-beta formation=淀粉样β形成的正向调节
Regulation of establishment of protein localization to mitochondrion=调控蛋白质定位于线粒体的建立
Multi-multicellular organism process=多细胞生物过程
Organic anion transport=有机阴离子运输
Positive regulation of cellular catabolic process=细胞分解代谢过程的正向调节
Regulation of developmental growth=发育生长的调节
Regulation of protein secretion=蛋白质分泌的调节
Regulation of intrinsic apoptotic signaling pathway=内在凋亡信号通路的调控
Calcium-mediated signaling=钙介导的信号传递
Cellular macromolecule biosynthetic process=细胞大分子生物合成过程
Positive regulation of mapk cascade=正向调节MAPK级联反应
Regulation of nitric-oxide synthase activity=对一氧化氮合酶活性的正向调节
Leukocyte differentiation=白细胞分化
Negative regulation of mitotic cell cycle phase transition=对有丝分裂细胞周期相转变的负调节
Regulation of the force of heart contraction by chemical signal=化学信号对心脏收缩力量的调节
Adenylate cyclase-inhibiting g protein-coupled receptor signaling pathway=腺苷环化酶抑制蛋白受体信号通路
Regulation of mononuclear cell proliferation=单核细胞增殖的调控
Positive regulation of cholesterol biosynthetic process=正向调节胆固醇生物合成过程
Mammary gland branching involved in pregnancy=乳腺分支:怀孕时涉及的乳腺分支
Positive regulation of transcription from rna polymerase ii promoter in response to hypoxia=rna聚合酶ii启动子在缺氧反应中的转录正调控
Lipoprotein metabolic process=脂蛋白代谢过程
Myeloid cell differentiation=髓系细胞分化
Negative regulation of epithelial cell differentiation=负调控上皮细胞分化
Plasma lipoprotein particle organization=血浆脂蛋白颗粒组织
Cellular response to angiotensin=细胞对血管紧张素的反应
Positive regulation of angiogenesis=血管生成的正向调节
Morphogenesis of a branching structure=分支结构的形态发生
Response to temperature stimulus=对温度刺激的正向调节
Positive regulation of protein kinase b signaling=对蛋白激酶b信号的正向调节
Response to cold=对冷刺激的反应
Positive regulation of cell cycle g1/s phase transition=对细胞周期G1/s相变的正向调节
Regulation of secretion by cell=细胞分泌的调节
Regulation of dna-templated transcription in response to stress=细胞对应激反应的DNA模板转录调节
Cellular response to uv=细胞对紫外线的反应
Regulation of fibroblast proliferation=成纤维细胞增殖的调节
Regulation of protein kinase b signaling=蛋白激酶b信号通路的调节
Negative regulation of cell cycle arrest=细胞周期阻滞的负调控
Cellular response to prostaglandin stimulus=细胞对前列腺素刺激的反应
Cellular hormone metabolic process=细胞激素代谢过程
Negative regulation of blood pressure=负调节血压
Ion homeostasis=离子体内平衡
Positive regulation of leukocyte cell-cell adhesion=正调控白细胞-细胞粘附
Multicellular organismal homeostasis=多细胞生物的体内平衡
Cell development=细胞发育
Phenol-containing compound metabolic process=含酚化合物代谢过程
Response to virus=对病毒的反应
Cell migration=细胞迁移
Behavior=行为
Regulation of protein kinase activity=蛋白激酶活性的调节
Regulation of anoikis=卵巢凋亡的调节
Embryonic placenta development=胚胎胎盘发育
Gene expression=基因表达
Phospholipid transport=磷脂运输
Regulation of chromosome organization=染色体组织的调节
Blood vessel development=血管发育
Smooth muscle contraction=平滑肌收缩
Female pregnancy=女性妊娠
Male gonad development=男性性腺发育
Cellular oxidant detoxification=细胞氧化解毒
Regulation of endothelial cell proliferation=内皮细胞增殖的调节
Macrophage differentiation=巨噬细胞分化
Response to immobilization stress=对制动应激的反应
Death-inducing signaling complex assembly=死亡诱导信号复合体组装
Regulation of oxidative stress-induced neuron intrinsic apoptotic signaling pathway=氧化应激诱导神经元内在凋亡信号通路的调节
Platelet activation=血小板活化
Positive regulation of defense response=防御反应的正调节
Cognition=认识
Blood coagulation=凝血
Positive regulation of receptor internalization=受体内化的正调节
Leukocyte cell-cell adhesion=白细胞-细胞黏附
Regulation of heart contraction=心脏收缩的调节
Positive regulation of g2/m transition of mitotic cell cycle=有丝分裂细胞周期G2/m转变的正调节
Cellular response to copper ion=细胞对铜离子的反应
Positive regulation of protein insertion into mitochondrial membrane involved in apoptotic signaling pathway=细胞对参与细胞凋亡信号通路的蛋白质插入的正调节
Regulation of tumor necrosis factor-mediated signaling pathway=肿瘤坏死因子介导的信号通路
Arachidonic acid metabolic process=花生四烯酸代谢途径
Mammary gland epithelium development=乳腺上皮发育
Regulation of oxidative stress-induced neuron death=氧化应激诱导神经元死亡的调节
Regulation of reactive oxygen species biosynthetic process=活性氧生物合成过程的调节
Circadian rhythm=昼夜节律
Negative regulation of cholesterol storage=负向调节胆固醇储存
Positive regulation of neuron apoptotic process=正向调节神经元凋亡过程
Anatomical structure homeostasis=解剖结构动态平衡
Regulation of protein serine/threonine kinase activity=蛋白丝氨酸/苏氨酸激酶活性的调节
In utero embryonic development=子宫胚胎发育
Epithelial cell development=上皮细胞发育
Positive regulation of leukocyte migration=正向调节白细胞迁移
Phospholipase c-activating g protein-coupled receptor signaling pathway=磷脂酶c激活g蛋白偶联受体信号通路
Regulation of organelle organization=细胞器组织的调节
Positive regulation of inflammatory response=炎症反应的正向调节
Cellular response to glucocorticoid stimulus=细胞对糖皮质激素刺激的反应
Export from cell=从细胞输出
Cell cycle checkpoint=细胞周期检查点
Regulation of heart rate=调节心率
Response to cobalt ion=对钴离子的反应
Regulation of nitric oxide biosynthetic process=一氧化氮生物合成过程的调节
Cellular response to lipoprotein particle stimulus=细胞对脂蛋白颗粒刺激的反应
Positive regulation of establishment of protein localization to mitochondrion=对蛋白质定位于线粒体的建立的正调节
Negative regulation of intrinsic apoptotic signaling pathway=对固有的凋亡信号通路的负调节
Learning or memory=学习或记忆
Viral process=病毒过程
Peptidyl-serine modification=肽-丝氨酸修饰
Negative regulation of cellular protein metabolic process=对细胞蛋白质代谢过程的负调节
Positive regulation of transcription from rna polymerase ii promoter in response to stress=应激反应中RNA聚合酶II启动子转录的正调节
Symbiotic process=共生过程
Negative regulation of calcium ion transport=钙离子转运的负调控
Cellular response to gamma radiation=细胞对伽马辐射的反应
Cellular response to dexamethasone stimulus=细胞对地塞米松刺激的反应
Nervous system development=神经系统发育
Negative regulation of cell development=细胞发育的负调控
Regulation of epithelial cell differentiation=调节上皮细胞分化
Regulation of histone modification=组蛋白修饰的调节
Cellular nitrogen compound metabolic process=细胞氮化合物代谢过程
ERBB2 signaling pathway=ERBB2信号通路
Cellular response to dna damage stimulus=细胞对dna损伤刺激的反应
Gas homeostasis=气体内稳态
Placenta development=胎盘发展
Locomotion=运动
Positive regulation of multicellular organism growth=正调控多细胞生物生长
Regulation of cellular component biogenesis=细胞成分生物发生的调节
Negative regulation of cellular component organization=细胞成分组织的负调控
Mitotic cell cycle checkpoint=有丝分裂细胞周期检查点
Cell aging=细胞衰老
Regulation of platelet activation=血小板活化的调节
cAMP-mediated signaling=cAMP-mediated信号
Secretion by cell=由细胞分泌
Signal transduction in response to dna damage=DNA损伤的信号转导
Cellular localization=细胞定位
Regulation of autophagy=自噬的调节
Protein processing=蛋白质加工
Mitotic g1 dna damage checkpoint=有丝分裂G1DNA损伤检查点
Response to retinoic acid=对维甲酸的反应
Intracellular lipid transport=细胞内脂质运输
Multicellular organismal reproductive process=多细胞生物生殖过程
Tissue morphogenesis=组织形态发生
Regulation of immune response=免疫反应的调节
Morphogenesis of a branching epithelium=分支上皮形态发生
Regulation of cell cycle arrest=调节细胞周期停滞
Regulation of peptide hormone secretion=肽激素分泌的调节
Regulation of multicellular organism growth=调节多细胞生物体生长
Regulation of muscle contraction=肌肉收缩调节
Negative regulation of cell adhesion=细胞黏附的负调节
Phosphorylation=磷酸化
Regulation of protein catabolic process=调节蛋白质分解代谢过程
Regulation of lymphocyte proliferation=淋巴细胞增殖调节
Positive regulation of g1/s transition of mitotic cell cycle=有丝分裂细胞周期G1/s转换的正调节
Tissue homeostasis=组织内稳态
Myeloid leukocyte differentiation=骨髓白细胞分化
Nitric oxide biosynthetic process=一氧化氮生物合成过程
Regulation of transporter activity=转运蛋白活性的调节
Xenobiotic catabolic process=异型生物质分解过程
Phospholipid homeostasis=磷脂体内平衡
Regulation of hemopoiesis=造血系统调节
Renal system process=肾系统进程
Peptidyl-threonine phosphorylation=肽基-苏氨酸磷酸化
Positive regulation of protein secretion=蛋白质分泌的正调节
Regulation of neurogenesis=神经发生的调节
Mitochondrial transport=线粒体运输
Cellular response to insulin stimulus=细胞对胰岛素刺激的反应
Negative regulation of catecholamine secretion=儿茶酚胺分泌的负调控
Synaptic transmission, gabaergic=突触传递、GABA能
Epithelium development=上皮发育
Lipid biosynthetic process=脂质生物合成过程
Regulation of transcription from rna polymerase ii promoter in response to stress=应激反应下RNA聚合酶II启动子转录的调节
Leukocyte activation=白细胞激活
Regulation of dna metabolic process=DNA代谢过程的调节
Regulation of erk1 and erk2 cascade=ERK1和ERK2级联过程的调节
Cellular response to acid chemical=细胞对酸性化学物质的反应
Signal transduction involved in dna damage checkpoint=dna损伤检查点的信号转导
Regulation of cell-matrix adhesion=细胞基质粘附的调节
Epithelial cell differentiation=上皮细胞分化
Cellular response to estradiol stimulus=细胞对雌二醇刺激的反应
Catabolic process=分解代谢的过程
Toxin metabolic process=毒素代谢过程
Low-density lipoprotein particle remodeling=低密度脂蛋白颗粒重塑
Lipoprotein catabolic process=脂蛋白分解过程
Positive regulation of macrophage differentiation=正向调节巨噬细胞分化
Regulation of establishment of endothelial barrier=调节内皮屏障的建立
Cellular protein modification process=细胞蛋白修饰过程
Negative regulation of response to external stimulus=对外部刺激反应的负调控
Regulation of intracellular estrogen receptor signaling pathway=细胞内雌激素受体信号通路的调控
Positive regulation of binding=约束的正向调节
Regulation of nervous system development=神经系统发育的调节
Transmembrane receptor protein tyrosine kinase signaling pathway=跨膜受体蛋白酪氨酸激酶信号通路
MAPK cascade=MAPK级联
Anatomical structure morphogenesis=解剖结构形态发生
Peptidyl-serine phosphorylation=肽-丝氨酸磷酸化
Heterocycle metabolic process=异环代谢过程
Negative regulation of secretion=分泌的负调节
Cellular extravasation=细胞外渗
Mammary gland morphogenesis=乳腺形态发生
Epithelial cell maturation=上皮细胞成熟
Intracellular cholesterol transport=细胞内胆固醇转运
Cellular response to thyroglobulin triiodothyronine=细胞对甲状腺球蛋白三碘甲状腺原氨酸的反应
Positive regulation of apoptotic signaling pathway=凋亡信号通路的正向调控
Regulation of protein-containing complex assembly=蛋白质复合物组装的调控
Regulation of insulin secretion=胰岛素分泌的调节
Ovulation cycle process=排卵周期过程
Regulation of ion transport=离子输送的调节
Regulation of muscle adaptation=肌肉适应调节
Positive regulation of nitric oxide biosynthetic process=一氧化氮生物合成过程的正向调控
Positive regulation of protein localization to membrane=蛋白质在膜上定位的正向调节
Animal organ morphogenesis=动物器官形态发生
Neurogenesis=神经发生
Regulation of cellular amide metabolic process=细胞酰胺代谢过程的调节
Reverse cholesterol transport=胆固醇的反向转运
Branching morphogenesis of an epithelial tube=上皮管的分支形态发生
Positive regulation of transferase activity=转移酶活性的正调节
Glucose homeostasis=葡萄糖稳态
Positive regulation of phospholipase c activity=磷脂酶c活性的正调节
Regulation of interleukin-1 beta production=白介素1β的产生
Negative regulation of cysteine-type endopeptidase activity involved in apoptotic process=参与细胞凋亡过程的半胱氨酸型内肽酶活性的负调节
Regulation of receptor signaling pathway via jak-stat=JAK-STAT对受体信号通路的负调节
Positive regulation of receptor signaling pathway via jak-stat=JAK-STAT受体信号通路的正调节
Negative regulation of smooth muscle cell proliferation=负向调节平滑肌细胞增殖
Monocyte differentiation=单核细胞分化
Regulation of i-kappab kinase/nf-kappab signaling=i-kappaB/nf-kappaB信号的负向调节
Negative regulation of gene silencing by mirna=miRNA负向调节基因沉默
Negative regulation of anoikis=负向调节细胞凋零
Regulation of cellular ketone metabolic process=细胞酮代谢过程
Regulation of acute inflammatory response=急性炎症反应的调节
Adenylate cyclase-activating g protein-coupled receptor signaling pathway=腺苷环化酶激活g蛋白偶联受体信号通路
Response to cocaine=对可卡因的反应
Positive regulation of protein kinase activity=蛋白激酶活性的正向调节
Digestive tract morphogenesis=消化道形态发生
Positive regulation of smooth muscle cell proliferation=平滑肌细胞增殖的正向调节
Leukocyte tethering or rolling=白细胞栓系或滚动
Cellular response to low-density lipoprotein particle stimulus=细胞对低密度脂蛋白颗粒刺激的反应
Negative regulation of oxidative stress-induced intrinsic apoptotic signaling pathway=氧化应激诱导的内在凋亡信号通路的负调控
Macromolecule modification=大分子损伤
Cellular response to alcohol=细胞对酒精的反应
Regulation of animal organ morphogenesis=动物器官形态发生的调控
Heterophilic cell-cell adhesion via plasma membrane cell adhesion molecules=通过质膜细胞粘附分子实现异嗜性细胞与细胞的粘附
Phospholipase c-activating g protein-coupled acetylcholine receptor signaling pathway=磷脂酶c-活化g蛋白偶联乙酰胆碱受体信号通路
Nitric oxide homeostasis=一氧化氮体内平衡
Negative regulation of inflammatory response=炎症反应的负调控
Tertiary branching involved in mammary gland duct morphogenesis=第三分支参与乳腺导管的形态发生
Cellular detoxification of nitrogen compound=氮化合物的细胞解毒作用
Positive regulation of prolactin secretion=促催乳素分泌
DNA damage checkpoint=DNA损伤检查点
Chordate embryonic development=脊索动物的胚胎发育
Regulation of myeloid cell differentiation=髓样细胞分化的调节
Cellular component organization=蜂窝组件的组织
Positive regulation of chondrocyte differentiation=对软骨细胞分化的正向调节
Response to starvation=应对饥饿
Positive regulation of neurogenesis=神经发生的正调控
Fatty acid derivative biosynthetic process=脂肪酸衍生物生物合成过程
Regulation of protein localization to membrane=蛋白质在膜上定位的调节
Negative regulation of cell migration=负向调节细胞迁移
Negative regulation of phosphate metabolic process=负向调节磷酸盐代谢过程
Movement of cell or subcellular component=细胞或亚细胞成分运动
Monocarboxylic acid transport=元羧酸酸性运输
Positive regulation of dna metabolic process=dna代谢过程的正调控
Ossification=骨化
Regulation of cold-induced thermogenesis=冷诱导产热的调节
Positive regulation of cellular extravasation=细胞外渗的正向调节
Positive regulation of growth=正向调节生长
Positive regulation of fibroblast proliferation=成纤维细胞增殖的正向调节
Blood vessel morphogenesis=血管形态发生
Adenylate cyclase-activating adrenergic receptor signaling pathway=腺苷酸环化酶激活肾上腺素能受体信号通路
Glutathione derivative biosynthetic process=谷胱甘肽衍生物生物合成过程
Regulation of cytokine production=调节细胞因子的产生
Homeostasis of number of cells=细胞数量的动态平衡
Regulation of transmembrane transporter activity=跨膜转运蛋白活性的调节
Regulation of endocytosis=内吞作用的调节
Small molecule biosynthetic process=小分子生物合成过程
Transmembrane transport=跨膜转运
Ovarian follicle development=卵巢卵泡发育
Negative regulation of smooth muscle cell migration=对平滑肌细胞迁移的负调节
Response to hyperoxia=高氧反应
Prostate gland epithelium morphogenesis=前列腺上皮形态发生
Regulation of cardiac muscle hypertrophy=心肌肥厚的调节
Cellular response to transforming growth factor beta stimulus=细胞对转化生长因子β刺激的反应
Positive regulation of cold-induced thermogenesis=冷诱导产热的正向调节
Cellular chemical homeostasis=细胞化学稳态
Positive regulation of erk1 and erk2 cascade=ERK1和ERK2的正向调节
Regulation of systemic arterial blood pressure=调节全身动脉血压
Cellular aldehyde metabolic process=细胞醛代谢过程
Nitrobenzene metabolic process=硝基苯代谢过程
Positive regulation of interleukin-1 beta production=白介素-1 β生成的正向调节
Response to cobalamin=氰钴胺素反应
Response to hydroxyisoflavone=应对羟基异黄酮
Negative regulation of dopamine secretion=多巴胺分泌负调节
Regulation of astrocyte activation=星形胶质细胞活化的调节
Response to 2,3,7,8-tetrachlorodibenzodioxine=对 2,3,7,8-四氯二苯并二恶英的反应
Regulation of myofibroblast differentiation=肌成纤维细胞分化的调节
Positive regulation of neuroblast proliferation=神经母细胞增殖的正向调节
Cholesterol efflux=胆固醇流出
Positive regulation of myeloid cell differentiation=正调控髓样细胞分化
Multi-organism process=多器官过程
Regulation of lipase activity=脂肪酶活性的调节
Negative regulation of neuron death=神经元死亡的负调控
Regulation of production of mirnas involved in gene silencing by mirna=MiRNA对参与基因沉默的miRNAs产生的调节
Negative regulation of defense response=对防御反应的负调节
Response to ischemia=对缺血的反应
Positive regulation of proteasomal ubiquitin-dependent protein catabolic process=蛋白酶体泛素依赖性蛋白质分解代谢过程的正向调节
Cellular catabolic process=细胞分解代谢的过程
Cellular response to starvation=细胞对饥饿的反应
Generation of neurons=神经元的生成
Negative regulation of reactive oxygen species metabolic process=对活性氧类代谢过程的负调节
B cell homeostasis=B细胞稳态
Regulation of carbohydrate metabolic process=碳水化合物代谢过程的调节
Positive regulation of myeloid leukocyte differentiation=髓系白细胞分化的正调节
Positive regulation of endocytosis=内吞作用的正向调节
Morphogenesis of an epithelium=上皮细胞的形态发生
DNA damage response, signal transduction by p53 class mediator resulting in cell cycle arrest=DNA损伤反应，p53类介质信号转导导致细胞周期阻滞
Peptidyl-amino acid modification=多肽-氨基酸修饰
Positive regulation of nf-kappab transcription factor activity=nf-kappaB转录因子活性的正向调节
Positive regulation of wound healing=对伤口愈合的正向调节
Regulation of anatomical structure size=解剖结构大小的负调节
Negative regulation of protein modification process=蛋白质修饰过程的负调节
Replicative cell aging=复制细胞衰老
Immune effector process=免疫效应过程
Response to iron(iii) ion=对铁离子的反应
Membrane to membrane docking=膜对膜对接
Receptor biosynthetic process=受体生物合成的过程
Triglyceride transport=甘油三酯转运
Positive regulation of endothelial cell chemotaxis by vegf-activated vascular endothelial growth factor receptor signaling pathway=通过血管内皮生长因子受体信号通路对内皮细胞趋化作用的正调节
Regulation of generation of precursor metabolites and energy=调节前体代谢物的产生和能量分泌
Saliva secretion=唾液分泌
Cellular response to staurosporine=星形孢菌素的细胞反应
Sphingolipid translocation=鞘磷脂转位
Positive regulation of apoptotic dna fragmentation=正向调节细胞DNA片段化
Positive regulation of cellular protein catabolic process=正向调节细胞蛋白分解代谢过程
Multi-organism reproductive process=多生物生殖过程
Negative regulation of cytokine-mediated signaling pathway=负调节细胞因子介导的信号通路
Heart valve development=心脏瓣膜发育
Artery morphogenesis=动脉形态发生
Anion homeostasis=阴离子稳态
Leukocyte apoptotic process=白细胞凋亡过程
Carboxylic acid transport=羧酸转运
Regulated exocytosis=调节胞外分泌
Regulation of t cell proliferation=调节T细胞增殖
Gamma-aminobutyric acid signaling pathway=γ-氨基丁酸信号通路
Plasma lipoprotein particle assembly=血浆脂蛋白颗粒组装
Positive regulation of cytosolic calcium ion concentration=正调节胞浆钙离子浓度
Regulation of nik/nf-kappab signaling=NIK/nf-kappaB信号的负调节
Negative regulation of immune system process=负调节免疫系统过程
Negative regulation of hydrolase activity=负调节水解酶活性
Regulation of binding=结合的调节
Cellular protein metabolic process=细胞蛋白代谢过程
Excitatory postsynaptic potential=兴奋性突触后电位
Maternal process involved in female pregnancy=参与女性妊娠的母体过程
Positive regulation of vascular endothelial growth factor production=正调节血管内皮生长因子的产生
Positive regulation of cardiac muscle hypertrophy=正调节心肌肥大
Positive regulation of blood coagulation=正调节凝血功能
Nucleotide-binding oligomerization domain containing signaling pathway=包含信号通路的核苷酸结合寡聚结构域
Activation of protein kinase activity=激活蛋白激酶活性
Positive regulation of attachment of spindle microtubules to kinetochore=纺锤体微管与着丝粒连接的正向调节
Response to uv-a=对UV-a的反应
Regulation of peptidyl-tyrosine autophosphorylation=肽基酪氨酸自磷酸化的调节
Positive regulation of oxidative stress-induced neuron death=氧化应激诱导的神经元死亡的正向调节
Pallium development=大脑皮层发育
Regulation of synaptic vesicle cycle=突触囊泡周期的调节
Regulation of dna biosynthetic process=dna生物合成过程的调控
Regulation of histone deacetylation=组蛋白去乙酰化的调节
Positive regulation of g protein-coupled receptor signaling pathway=蛋白偶联受体信号通路的正调控
Negative regulation of fibroblast proliferation=对成纤维细胞增殖的负调节
Metal ion homeostasis=金属离子稳态
Positive regulation of cytokine production=对细胞因子产生的正向调节
Fc-epsilon receptor signaling pathway=Fc-epsilon受体信号通路
Epithelial tube morphogenesis=管上皮细胞形态发生
Cerebral cortex development=大脑皮层发育
Response to carbohydrate=碳水化合物反应
Cellular response to interleukin-1=细胞对白细胞介素-1的反应
Positive regulation of cyclin-dependent protein serine/threonine kinase activity=正向调节细胞周期蛋白依赖的丝氨酸/苏氨酸激酶活性
Positive regulation of smooth muscle contraction=正向调节平滑肌收缩
Regulation of ruffle assembly=正向调节褶皱组装
Positive regulation of protein catabolic process=正向调节蛋白质分解代谢过程
Positive regulation of developmental growth=正向调节发育生长
Leukocyte homeostasis=白细胞稳态
Regulation of toll-like receptor signaling pathway=Toll样受体信号通路调节
Cellular response to amino acid stimulus=细胞对氨基酸刺激的反应
Leukocyte mediated immunity=白细胞介导的免疫
Regulation of gliogenesis=神经胶质形成的调节
Regulation of purine nucleotide metabolic process=嘌呤核苷酸代谢过程的调节
Urogenital system development=泌尿生殖系统发育
Positive regulation of monooxygenase activity=单加氧酶活性的正调节
Response to morphine=对吗啡的反应
Liver regeneration=肝再生
Negative regulation of wound healing=伤口愈合的负调节
Lipid hydroxylation=脂质羟化
Regulation of phospholipid catabolic process=磷脂分解代谢过程的调节
Cellular response to hyperoxia=细胞对高氧的反应
Organic substance catabolic process=有机物分解代谢过程
Regulation of myeloid leukocyte differentiation=髓系白细胞分化的调节
Cellular modified amino acid metabolic process=细胞修饰氨基酸代谢过程
Protein-containing complex subunit organization=含蛋白复合亚单位组织
Regulation of glial cell differentiation=调节神经胶质细胞分化
Aortic valve development=主动脉瓣发育
Memory=记忆
Retinoic acid metabolic process=维甲酸代谢过程
Response to mineralocorticoid=对糖皮质激素的反应
Icosanoid transport=异体转运
Regulation of atp metabolic process=对ATP代谢过程的调节
Signal transduction by p53 class mediator=P53类调节因子的信号转导
Cellular metal ion homeostasis=细胞金属离子稳态
Estrogen metabolic process=雌激素代谢过程
Regulation of hormone metabolic process=激素代谢过程的调节
Positive regulation of chromosome segregation=染色体分离的正向调节
Cellular response to interleukin-6=细胞对白细胞介素6的反应
Phosphate-containing compound metabolic process=含磷化合物代谢过程
Pattern recognition receptor signaling pathway=模式识别受体信号通路
Tumor necrosis factor-mediated signaling pathway=肿瘤坏死因子介导的信号通路
Hair follicle development=毛囊发育
Acute inflammatory response=急性炎症反应
I-kappaB kinase/NF-kappaB signaling=I-kappaB激酶/核因子-kappaB信号转导
Fatty acid transport=脂肪酸转运
Digestive system process=消化系统过程
Osteoblast differentiation=成骨细胞分化
DNA damage induced protein phosphorylation=DNA损伤诱导蛋白磷酸化
Activation of phospholipase c activity=磷脂酶c活性激活
Long-term memory=长期记忆
Mating=交配
Chylomicron remnant clearance=乳糜微粒残留间隙
Response to fluid shear stress=流体剪切应力的响应
Positive regulation of hormone biosynthetic process=激素生物合成过程的正向调节
Hydrogen peroxide biosynthetic process=过氧化氢生物合成过程
Micturition=排尿
Nucleotide-binding oligomerization domain containing 2 signaling pathway=包含2个信号的核苷酸结合寡聚结构域
Cellular response to testosterone stimulus=细胞对睾酮刺激的反应
Positive regulation of er-associated ubiquitin-dependent protein catabolic process=er相关泛素依赖蛋白分解代谢过程的正向调节
Positive regulation of leukocyte tethering or rolling=白细胞束缚或滚动的阳性调节
Regulation of dna binding=dna结合的调控
Telencephalon development=端脑发育
Associative learning=联想学习
Macromolecule localization=大分子局部化
Extrinsic apoptotic signaling pathway via death domain receptors=通过死亡结构域受体的外源性凋亡信号途径
Cellular component assembly=细胞组件组装
Negative regulation of blood circulation=对血液循环的负调节
Liver development=肝脏发育
Platelet degranulation=血小板脱颗粒
Regulation of dna repair=调节DNA修复
G protein-coupled receptor signaling pathway=G蛋白偶联受体信号通路
Negative regulation of protein phosphorylation=负调节蛋白质磷酸化
Divalent inorganic cation homeostasis=二价无机阳离子动态平衡
Regulation of ion transmembrane transporter activity=离子跨膜转运蛋白活性调节
Negative regulation of epithelial cell proliferation=负调节上皮细胞增殖
Androgen receptor signaling pathway=雄激素受体信号通路
Cellular response to nutrient=细胞对营养的响应
Regulation of transcription from rna polymerase ii promoter in response to hypoxia=RNA聚合酶II启动子转录调控对缺氧的响应
RNA metabolic process=RNA代谢过程
Establishment of localization in cell=细胞定位的建立
Extracellular matrix organization=细胞外基质组织
Ovulation from ovarian follicle=卵泡排卵
Regulation of tyrosine phosphorylation of stat protein=调节STAT蛋白酪氨酸磷酸化
CD8-positive, alpha-beta T cell differentiation=CD8阳性、α-βT细胞分化
Daunorubicin metabolic process=柔红霉素代谢过程
Doxorubicin metabolic process=阿霉素代谢过程
Lateral sprouting from an epithelium=从上皮细胞侧向发芽
Positive regulation of deacetylase activity=脱乙酰基酶活性的正向调节
Omega-hydroxylase p450 pathway=欧米伽-羟基酶P450途径
Regulation of somatic stem cell population maintenance=躯体干细胞群维持的调节
Regulation of amyloid fibril formation=淀粉原纤维形成的调节
Regulation of glycogen (starch) synthase activity=糖原(淀粉)代谢酶活性的调节
Superoxide metabolic process=超氧化物过程
Positive regulation of secretion=分泌的正调节
Regulation of synaptic vesicle exocytosis=突触囊泡的正向调节
Regulation of ossification=骨化的调节
Regulation of cell division=细胞分裂的正调节
Regulation of cell growth=细胞生长的调节
ER-nucleus signaling pathway=ER核信号通路
Negative regulation of blood vessel diameter=负调节血管直径
Female gamete generation=雌配子生成
Negative regulation of protein serine/threonine kinase activity=负调节蛋白丝氨酸/苏氨酸激酶活性
Response to osmotic stress=对渗透应激的反应
Striated muscle cell differentiation=横纹肌细胞分化
Positive regulation of nik/nf-kappab signaling=对Nik/nf-kappaB信号的正调节
Response to testosterone=对睾酮的正调节
Hydrogen peroxide metabolic process=过氧化氢代谢过程
Positive regulation of protein serine/threonine kinase activity=对蛋白质丝氨酸/苏氨酸激酶活性的正调节
Positive regulation of response to endoplasmic reticulum stress=对内质网应激反应的正调节
Negative regulation of cell activation=细胞激活的负调节
Regulation of nitric oxide mediated signal transduction=一氧化氮介导的信号转导的调控
Chylomicron assembly=乳糜微粒组装
Regulation of uterine smooth muscle contraction=子宫平滑肌收缩的调节
Positive regulation of protein kinase c signaling=蛋白激酶C信号的正调节
Establishment of endothelial intestinal barrier=肠内皮屏障的建立
Hydrocarbon metabolic process=碳氢化合物代谢过程
Protein-containing complex assembly=含蛋白复合体组件
Regulation of chemokine production=趋化因子产生的调节
Negative regulation of response to dna damage stimulus=对DNA损伤刺激反应的负调控
Cellular response to vascular endothelial growth factor stimulus=细胞对血管内皮生长因子刺激的反应
Cellular response to osmotic stress=细胞对渗透应激的反应
Positive regulation of protein binding=对蛋白结合的正调控
Glial cell activation=胶质细胞激活
Regulation of extracellular matrix organization=对细胞外基质组织的调控
Cell junction assembly=细胞连接组装
Mitotic cell cycle phase transition=有丝分裂细胞周期相变
Negative regulation of leukocyte proliferation=对白细胞增殖的负调控
Regulation of epithelial cell apoptotic process=对上皮细胞凋亡过程的负调控
Defense response to other organism=对其他生物的防御反应
Protein deubiquitination=蛋白质去泛素化
Response to insecticide=对杀虫剂的反应
Cyclooxygenase pathway=环氧合酶途径
Positive regulation of mrna 3-end processing=对mRNA3端加工的正向调节
Positive regulation of heat generation=对热产生的正向调节
Negative regulation of collagen biosynthetic process=对胶原生物合成过程的负调节
Response to vitamin e=对维生素e的应答
Leydig cell differentiation=间质细胞分化
Response to histamine=对组胺的应答
Neurotransmitter catabolic process=神经递质分解过程
Skin morphogenesis=皮肤形态发生
Regulation of transcription from rna polymerase ii promoter in response to oxidative stress=氧化应激对RNA聚合酶II启动子转录的调节
Prostate glandular acinus development=前列腺腺泡发育
Positive regulation of production of mirnas involved in gene silencing by mirna=正向调节miRNA参与基因沉默的miRNA的产生
Cellular calcium ion homeostasis=细胞钙离子稳态
Regulation of digestive system process=消化系统过程调节
Regulation of rho protein signal transduction=Rho蛋白信号转导调节
Positive regulation of ossification=正向调节骨化
Regulation of leukocyte activation=正向调节白细胞活化
Regulation of lymphocyte activation=调节淋巴细胞活化
Mesenchyme development=间质发育
Regulation of response to endoplasmic reticulum stress=对内质网应激反应的调节
Positive regulation of ion transport=正向调节离子转运
Regulation of leukocyte differentiation=调节白细胞分化
Modulation of chemical synaptic transmission=调节化学突触传递
Negative regulation of endothelial cell proliferation=负向调节内皮细胞增殖
Regulation of bone resorption=骨吸收调节
Positive regulation of synaptic transmission=正向调节突触传递
Positive regulation of chemotaxis=正向调节趋化作用
Cellular response to epidermal growth factor stimulus=细胞对表皮生长因子刺激的反应
Regulation of autophagy of mitochondrion=调节线粒体自噬
Activation of cysteine-type endopeptidase activity involved in apoptotic process=参与细胞凋亡过程的半胱氨酸型内肽酶活性激活
Protein tetramerization=蛋白质四聚化
Response to monosaccharide=应对单糖
Regulation of cell cycle g2/m phase transition=细胞周期g2/m相变的调控
Nervous system process involved in regulation of systemic arterial blood pressure=参与全身动脉血压调节的神经系统过程
Endocardial cushion development=心内膜缓冲发育
Ethanol oxidation=乙醇氧化
Acute-phase response=急性时相反应
Mitotic nuclear envelope disassembly=有丝分裂核膜解体
Negative regulation of heart rate=负性调节心率
Zymogen activation=酶原激活
Response to peptidoglycan=对肽聚糖的反应
Positive regulation of intracellular estrogen receptor signaling pathway=细胞内雌激素受体信号通路的正调节
Mammary gland epithelial cell proliferation=乳腺上皮细胞增殖
Phospholipid efflux=磷脂外流
Very-low-density lipoprotein particle assembly=极低密度脂蛋白颗粒集合
Response to antibiotic=对抗生素的反应
Behavioral response to cocaine=可卡因的行为反应
Response to calcium ion=对钙离子的反应
Prostate gland growth=前列腺生长
Epithelial cell differentiation involved in prostate gland development=参与前列腺发育的上皮细胞分化
Positive regulation of ceramide biosynthetic process=对神经酰胺生物合成过程的正向调节
Negative regulation of cation channel activity=对阳离子通道活性的负调节
Cell activation involved in immune response=参与免疫反应的细胞激活
Interaction with host=与宿主的相互作用
Regulation of phospholipid metabolic process=磷脂代谢过程的调节
Cell adhesion=细胞黏附
Negative regulation of transferase activity=对转移酶活性的负调节
Muscle tissue development=肌肉组织发育
Negative regulation of secretion by cell=细胞分泌的负调节
Positive regulation of endothelial cell proliferation=内皮细胞增殖的正向调节
Collagen fibril organization=胶原原纤维组织
Lipid translocation=脂质易位
Thymus development=胸腺发育
Negative regulation of acute inflammatory response=急性炎症反应的负调控
Muscle system process=肌肉系统进程
Flavonoid metabolic process=类黄酮代谢过程
Positive regulation of triglyceride biosynthetic process=正向调节甘油三酯生物合成过程
Removal of superoxide radicals=去除超氧自由基
Positive regulation of histone modification=组蛋白修饰正向调节
Triglyceride-rich lipoprotein particle remodeling=富含甘油三酯的脂蛋白颗粒重塑
Positive regulation of insulin-like growth factor receptor signaling pathway=胰岛素样生长因子受体信号通路的正调控
Viral entry into host cell=病毒进入宿主细胞
Regulation of chemotaxis=调节趋化作用
Regulation of gastric acid secretion=调节胃酸分泌
Positive regulation of digestive system process=积极调节消化系统过程
Regulation of vesicle-mediated transport=调控囊泡介导的转运
Replicative senescence=复制衰老
Ether biosynthetic process=醚生物合成的过程
Regulation of tau-protein kinase activity=tau蛋白激酶活性的调节
Amyloid fibril formation=淀粉样原纤维形成
Synapse assembly=突触组装
Visual learning=视觉学习
Negative regulation of blood coagulation=凝血功能负调节
Organ growth=器官生长
Negative regulation of i-kappab kinase/nf-kappab signaling=i-kappab激酶/nf-kappab信号的负调控
Icosanoid biosynthetic process=类胰岛生物合成过程
Tissue remodeling=组织重构
interleukin-1-mediated signaling pathway=IL-1介导的信号通路
Mitotic nuclear division=有丝分裂核分裂
Regulation of long-term synaptic potentiation=长期突触增强的调节
Positive regulation of purine nucleotide metabolic process=嘌呤核苷酸代谢过程的正调控
Positive regulation of atp metabolic process=正调控atp代谢过程
Negative regulation of hemopoiesis=造血的负调控
Regulation of cyclin-dependent protein serine/threonine kinase activity=周期蛋白依赖性蛋白丝氨酸/苏氨酸激酶活性的调节
Regulation of innate immune response=先天免疫反应的调节
Skin development=皮肤发展
Genitalia development=生殖器发育
Positive regulation of leukocyte chemotaxis=白细胞趋化性的正向调节
Transforming growth factor beta receptor signaling pathway=转化生长因子受体信号通路
Regulation of protein tyrosine kinase activity=蛋白质酪氨酸激酶活性的调节
Alpha-beta t cell lineage commitment=α-βT细胞谱系提交
Melanin metabolic process=黑色素代谢过程
Response to laminar fluid shear stress=层流剪切应力的响应
Regulation of transmembrane transport=跨膜转运的调控
Genitalia morphogenesis=生殖器形态发生
Retinal metabolic process=视网膜代谢过程
Lipoprotein transport=脂蛋白运输
Lipid digestion=脂类的消化
Negative regulation of necroptotic process=坏死过程的负调控
Cellular response to estrogen stimulus=细胞对雌激素刺激的反应
Negative regulation of production of mirnas involved in gene silencing by mirna=mirna对基因沉默中涉及的mirna生产的负调控
Glutathione metabolic process=谷胱甘肽代谢过程
Regulation of cyclase activity=调控环化酶活性
Execution phase of apoptosis=细胞凋亡的执行阶段
Immune response=免疫反应
Forebrain development=前脑发育
Toll-like receptor signaling pathway=Toll样受体信号通路
Positive regulation of peptide hormone secretion=正调节肽激素分泌
Regulation of neurotransmitter levels=神经递质水平的调节
Regulation of mitotic nuclear division=有丝分裂核分裂的调节
Regulation of endothelial cell apoptotic process=内皮细胞凋亡过程的调控
Cell morphogenesis involved in differentiation=细胞形态发生与分化有关
Regulation of fatty acid metabolic process=脂肪酸代谢过程的调节
Pathways in cancer=癌症中的通路
MicroRNAs in cancer=癌症中的小分子核糖核酸
Fluid shear stress and atherosclerosis=流体剪切应力和动脉粥样硬化
Prostate cancer=前列腺癌
Human cytomegalovirus infection=人类巨细胞病毒感染
Kaposi sarcoma-associated herpesvirus infection=卡波济肉瘤相关疱疹病毒感染
AGE-RAGE signaling pathway in diabetic complications=糖尿病并发症中的AGE-RAGE信号通路
Hepatitis B=乙型肝炎
PI3K-Akt signaling pathway=PI3K-Akt信号通路
Apoptosis=细胞凋亡
Proteoglycans in cancer=癌症中的蛋白多糖
TNF signaling pathway=肿瘤坏死因子信号通路
Thyroid hormone signaling pathway=甲状腺激素信号通路
Hepatitis C=丙型肝炎
Epstein-Barr virus infection=eb病毒感染
Hepatocellular carcinoma=肝细胞癌
MAPK signaling pathway=MAPK信号通路
Bladder cancer=膀胱癌
Small cell lung cancer=小细胞肺癌
Non-small cell lung cancer=非小细胞肺癌
Endocrine resistance=内分泌的阻力
Pancreatic cancer=胰腺癌
Influenza A=甲型流感
Human immunodeficiency virus 1 infection=人类免疫缺陷病毒1型感染
Salmonella infection=沙门氏菌感染
Toxoplasmosis=弓形体病
Measles=麻疹
Legionellosis=军团病
Colorectal cancer=结肠直肠癌
Breast cancer=乳腺癌
Neuroactive ligand-receptor interaction=神经活性配体-受体相互作用
Relaxin signaling pathway=松弛素信号通路
Prolactin signaling pathway=催乳激素信号通路
Platinum drug resistance=铂耐药
p53 signaling pathway=p53信号通路
Th17 cell differentiation=Th17细胞分化
Estrogen signaling pathway=雌激素信号通路
Human T-cell leukemia virus 1 infection=人类T细胞白血病病毒1型感染
Alzheimer disease=阿尔茨海默病
C-type lectin receptor signaling pathway=c型凝集素受体信号通路
Apoptosis - multiple species=细胞凋亡--多种物种
Pertussis=百日咳
HIF-1 signaling pathway=HIF-1信号通路
Insulin resistance=胰岛素抵抗
EGFR tyrosine kinase inhibitor resistance=EGFR酪氨酸激酶抑制剂耐药
Non-alcoholic fatty liver disease=非酒精性脂肪肝
Pathogenic Escherichia coli infection=致病性大肠杆菌感染
ErbB signaling pathway=ErbB信号通路
Endometrial cancer=子宫内膜癌
Focal adhesion=灶性粘连
IL-17 signaling pathway=IL-17信号通路
Transcriptional misregulation in cancer=癌症中的转录调控错误
Insulin signaling pathway=胰岛素信号通路
Metabolism of xenobiotics by cytochrome P450=细胞色素P450对异种生物的代谢作用
Adipocytokine signaling pathway=脂肪细胞因子信号通路
NF-kappa B signaling pathway=NF-kappa B信号通路
Human papillomavirus infection=人类乳头瘤病毒感染
Chemical carcinogenesis=化学致癌作用
Chronic myeloid leukemia=慢性骨髓性白血病
Gastric cancer=胃癌
Cellular senescence=细胞衰老
Calcium signaling pathway=钙信号通路
Sphingolipid signaling pathway=鞘脂类信号通路
cAMP signaling pathway=cAMP信号通路
FoxO signaling pathway=FoxO信号通路
Tuberculosis=肺结核
Shigellosis=志贺氏菌病
Ras signaling pathway=Ras信号通路
Chagas disease=恰加斯病
Parathyroid hormone synthesis, secretion and action=甲状旁腺激素的合成、分泌和作用
Cholinergic synapse=胆碱能突触
Cell cycle=细胞周期
Yersinia infection=鼠疫感染
Viral myocarditis=病毒性心肌炎
PD-L1 expression and PD-1 checkpoint pathway in cancer=PD-L1在癌症中的表达和PD-1检查点通路
Antifolate resistance=抗叶酸抗性
VEGF signaling pathway=VEGF信号通路
Drug metabolism - cytochrome P450=药物代谢-细胞色素P450
African trypanosomiasis=非洲锥虫病
Amoebiasis=阿米巴病
Thyroid cancer=甲状腺癌
Toll-like receptor signaling pathway=toll样受体信号通路
T cell receptor signaling pathway=T细胞受体信号通路
Acute myeloid leukemia=急性髓系白血病
Epithelial cell signaling in Helicobacter pylori infection=幽门螺杆菌感染中的上皮细胞信号转导
Central carbon metabolism in cancer=癌症的中枢碳代谢
Glioma=神经胶质瘤
Neurotrophin signaling pathway=神经营养因子信号通路
B cell receptor signaling pathway=B细胞受体信号通路
Malaria=疟疾
AMPK signaling pathway=AMPK信号通路
Osteoclast differentiation=破骨细胞分化
NOD-like receptor signaling pathway=nod样受体信号通路
Ovarian steroidogenesis=卵巢类固醇生成
Viral carcinogenesis=病毒致癌作用
Choline metabolism in cancer=癌症中的胆碱代谢
Galactose metabolism=半乳糖代谢
Cytosolic DNA-sensing pathway=胞质DNA传感途径
Oxytocin signaling pathway=催产素信号通路
Cushing syndrome=库欣综合症
Serotonergic synapse=含血清素的神经突触
JAK-STAT signaling pathway=JAK-STAT信号通路
RIG-I-like receptor signaling pathway=rig - i样受体信号通路
Melanoma=黑素瘤
Nicotine addiction=尼古丁上瘾
Growth hormone synthesis, secretion and action=生长激素的合成、分泌和作用
Dopaminergic synapse=多巴胺能神经突触
Metabolic pathways=代谢途径
ABC transporters=ABC转运蛋白
GABAergic synapse=gaba ergic突触
Type II diabetes mellitus=II型糖尿病
Th1 and Th2 cell differentiation=Th1和Th2细胞分化
Cholesterol metabolism=胆固醇代谢
GnRH signaling pathway=促性腺激素信号通路
Retrograde endocannabinoid signaling=逆行神经的信号
Necroptosis=坏死性凋亡
Steroid hormone biosynthesis=类固醇激素生物合成
Glycolysis / Gluconeogenesis=糖酵解/糖异生
beta-Alanine metabolism=β-丙氨酸代谢
Fc epsilon RI signaling pathway=Fc epsilon RI信号通路
Leishmaniasis=利什曼病
Drug metabolism - other enzymes=药物代谢-其他酶
PPAR signaling pathway=PPAR信号通路
Tyrosine metabolism=酪氨酸代谢
Autophagy - animal=自噬--动物
Prion disease=朊病毒疾病
Rheumatoid arthritis=类风湿性关节炎
Tryptophan metabolism=色氨酸代谢
Fat digestion and absorption=脂肪消化吸收
Gap junction=缝隙连接
Regulation of actin cytoskeleton=肌动蛋白细胞骨架的调节
Morphine addiction=吗啡成瘾
mTOR signaling pathway=mTOR信号通路
Progesterone-mediated oocyte maturation=孕酮介导的卵母细胞成熟
Wnt signaling pathway=Wnt信号通路
Melanogenesis=黑素生成
Huntington disease=亨廷顿病
Hedgehog signaling pathway=Hedgehog信号通路
Cocaine addiction=可卡因成瘾
Herpes simplex virus 1 infection=单纯疱疹病毒1型感染
Glutathione metabolism=谷胱甘肽代谢
Parkinson disease=帕金森病
Fatty acid biosynthesis=脂肪酸生物合成
Long-term depression=长期的抑郁
Arachidonic acid metabolism=花生四烯酸代谢
Chemokine signaling pathway=趋化因子信号通路
Mitophagy - animal=吞噬有丝分裂-动物
Natural killer cell mediated cytotoxicity=自然杀伤细胞介导的细胞毒性
GnRH secretion=促性腺激素分泌
Histidine metabolism=组氨酸代谢
Retinol metabolism=视黄醇的新陈代谢
Platelet activation=血小板激活
Long-term potentiation=长期势差
Amyotrophic lateral sclerosis=肌萎缩性脊髓侧索硬化症
Amphetamine addiction=苯丙胺成瘾
Renal cell carcinoma=肾细胞癌
Rap1 signaling pathway=Rap1信号通路
Vitamin digestion and absorption=维生素的消化吸收
Folate biosynthesis=叶酸生物合成
Spinocerebellar ataxia=脊髓小脑的共济失调
Gastric acid secretion=胃酸分泌
Cell adhesion molecules=细胞粘附分子
Complement and coagulation cascades=补体和凝血级联
Hippo signaling pathway=Hippo 信号通路
Fructose and mannose metabolism=果糖和甘露糖代谢
Starch and sucrose metabolism=淀粉和蔗糖的代谢
Staphylococcus aureus infection=金黄色葡萄球菌感染
Tight junction=紧密连接
Base excision repair=碱基切除修复
Propanoate metabolism=丙酸代谢
Salivary secretion=唾液分泌
Bile secretion=胆汁分泌
cGMP-PKG signaling pathway=cGMP-PKG信号通路
Signal Transduction=信号转导
Signaling by Nuclear Receptors=核受体信号传递
Signaling by Interleukins=白介素信号转导途径
Generic Transcription Pathway=通用转录途径
ESR-mediated signaling=ESR介导的信号
Nuclear Receptor transcription pathway=核受体转录途径
Interleukin-4 and Interleukin-13 signaling=白细胞介素-4和白细胞介素-13信号
Metabolism=新陈代谢
SUMO E3 ligases SUMOylate target proteins=SUMO E3连接酶Sumoylate靶蛋白
Extra-nuclear estrogen signaling=核外雌激素信号转导
Cytokine Signaling in Immune system=免疫系统中的细胞因子信号
Phase I - Functionalization of compounds=化合物的第一阶段功能
Biological oxidations=生物氧化反应
Immune System=免疫系统
Signaling by Receptor Tyrosine Kinases=受体酪氨酸激酶的信号传导
Metabolism of lipids=脂质代谢
Amine ligand-binding receptors=胺受体配体结合
NR1H2 and NR1H3-mediated signaling=NR1H2和nr1h3介导的信号传导
Intrinsic Pathway for Apoptosis=细胞凋亡的内在途径
Innate Immune System=先天免疫系统
SUMOylation of intracellular receptors=胞内受体的总甲基化
Signaling by PTK6=PTK6信号转导途径
Nucleotide-binding domain, leucine rich repeat containing receptor (NLR) signaling pathways=核苷酸结合域和富含亮氨酸重复序列的受体(NLR)信号通路
Transcriptional regulation by RUNX2=RUNX2的转录调控
Estrogen-dependent gene expression=雌激素依赖性基因表达
Muscarinic acetylcholine receptors=毒蕈碱的乙酰胆碱受体
Toll Like Receptor 3 (TLR3) Cascade=Toll样受体3 (TLR3)级联
Disease=疾病
TRIF(TICAM1)-mediated TLR4 signaling=TRIF (TICAM1)介导TLR4信号
Cytochrome P450 - arranged by substrate type=细胞色素P450-按底物类型排列
Hemostasis=止血
PI3K/AKT Signaling in Cancer=PI3K/AKT在癌症中的信号通路
Cellular responses to stress=细胞对应激的反应
Estrogen-dependent nuclear events downstream of ESR-membrane signaling=ESR膜信号下游雌激素依赖性核事件
Toll-like Receptor Cascades=Toll样受体级联
PPARA activates gene expression=PPARA激活基因表达
MyD88 cascade initiated on plasma membrane=质膜上启动的MyD88级联
TFAP2 (AP-2) family regulates transcription of growth factors and their receptors=TFAP2 (AP-2)家族调节生长因子及其受体的转录
TRAF6 mediated induction of NFkB and MAP kinases upon TLR7/8 or 9 activation=TRAF6介导TLR7/8或9激活NFkB和MAP激酶
Signaling by ERBB4=ERBB4信号
Arachidonic acid metabolism=花生四烯酸代谢
MyD88:MAL(TIRAP) cascade initiated on plasma membrane=MyD88：启动质膜上的MAL(TIRAP)级联
Interleukin-1 family signaling=白介素-1家族信号
Transcriptional regulation by the AP-2 (TFAP2) family of transcription factors=AP-2 (TFAP2)家族转录因子的转录调控
NR1H3 & NR1H2 regulate gene expression linked to cholesterol transport and efflux=NR1H3和NR1H2调控与胆固醇转运和外排相关的基因表达
Intracellular signaling by second messengers=第二信使的细胞内信号
Circadian Clock=生物钟
Plasma lipoprotein assembly, remodeling, and clearance=血浆脂蛋白组装、重塑和清除
Activation of gene expression by SREBF (SREBP)=SREBF (SREBP)激活基因表达
PIP3 activates AKT signaling=PIP3激活AKT信号
Transmission across Chemical Synapses=跨化学突触的传递
Inflammasomes=炎性小体
Activation of caspases through apoptosome-mediated cleavage=通过凋亡介导的裂解激活caspase
SHC1 events in ERBB2 signaling=ERBB2信号中的SHC1事件
Apoptosis=细胞凋亡
Transcriptional regulation of white adipocyte differentiation=白色脂肪细胞分化的转录调控
Fatty acid metabolism=脂肪酸代谢
SMAC (DIABLO) binds to IAPs=Smac(Diablo)结合IAP
SMAC(DIABLO)-mediated dissociation of IAP:caspase complexes=Smac(Diablo)介导IAP的解离：Caspase复合体
IkBA variant leads to EDA-ID=IkBA变体导致EDA-ID
TRAF6 mediated NF-kB activation=TRAF6介导的NF-kB激活
Endogenous sterols=内生植物固醇
Metabolism of vitamins and cofactors=维生素和辅助因子的代谢
Post-translational protein modification=翻译后的蛋白质修饰
Death Receptor Signalling=死亡受体信号
NR1H2 & NR1H3 regulate gene expression linked to lipogenesis=NR1H2和NR1H3调控与脂肪生成相关的基因表达
VEGFA-VEGFR2 Pathway=VEGFA-VEGFR2通路
Diseases of signal transduction by growth factor receptors and second messengers=生长因子受体和第二信使信号转导的疾病
Platelet activation, signaling and aggregation=血小板活化、信号转导和聚集
Metabolism of steroids=类固醇代谢
TAK1 activates NFkB by phosphorylation and activation of IKKs complex=TAK1通过磷酸化和激活IKKs复合物激活NFkB
Neuronal System=神经系统
Caspase-mediated cleavage of cytoskeletal proteins=caspase介导的细胞骨架蛋白的裂解
NOD1/2 Signaling Pathway=NOD1/2信号通路
NF-kB is activated and signals survival=NF-kB被激活并发出存活信号
Chk1/Chk2(Cds1) mediated inactivation of Cyclin B:Cdk1 complex=Chk1/Chk2(Cds1)介导的Cyclin B:Cdk1复合体失活
ERBB2 Activates PTK6 Signaling=ERBB2激活PTK6信号
Regulation of RUNX2 expression and activity=调节RUNX2的表达和活性
AKT phosphorylates targets in the cytosol=AKT磷酸化胞浆靶标
DDX58/IFIH1-mediated induction of interferon-alpha/beta=DDX58/IFIH1介导的干扰素-α/β
Synthesis of bile acids and bile salts via 27-hydroxycholesterol=通过27-羟基胆固醇合成胆汁酸和胆盐
ERBB2 Regulates Cell Motility=ERBB2调节细胞运动
The NLRP3 inflammasome=NLRP3炎症体
Constitutive Signaling by Aberrant PI3K in Cancer=肿瘤中异常PI3K的本构信号
Extracellular matrix organization=细胞外基质的组织
PI3K events in ERBB2 signaling=PI3K事件在ERBB2信号中的作用
RIP-mediated NFkB activation via ZBP1=通过ZBP1激活rip介导的NFkB
Fc epsilon receptor (FCERI) signaling=Fc epsilon受体(FCERI)信号
Metabolism of proteins=蛋白质代谢
G1/S Transition=G1 / S过渡
Biosynthesis of DHA-derived SPMs=dha衍生SPMs的生物合成
Response to elevated platelet cytosolic Ca2+=血小板胞质Ca2+升高的反应
RORA activates gene expression=RORA激活基因表达
Scavenging by Class A Receptors=被A类受体清除
MAPK family signaling cascades=MAPK家族信号级联
C-type lectin receptors (CLRs)=c型凝集素受体(CLRs)
Cell surface interactions at the vascular wall=血管壁上细胞表面的相互作用
Class A/1 (Rhodopsin-like receptors)=A/1类(视紫红质样受体)
VEGFR2 mediated cell proliferation=VEGFR2介导细胞增殖
Plasma lipoprotein assembly=血浆脂蛋白组装
Neurotransmitter receptors and postsynaptic signal transmission=神经递质受体和突触后信号传递
p75 NTR receptor-mediated signalling=p75 NTR受体介导的信号转导
CLEC7A (Dectin-1) signaling=CLEC7A(Dectin-1)信号转导
Signaling by ERBB2 TMD/JMD mutants=ERBB2 TMD/JMD突变体的信号转导
HSP90 chaperone cycle for steroid hormone receptors (SHR)=类固醇激素受体(SHR)HSP90伴侣环
PLCG1 events in ERBB2 signaling=PLCG1在ERBB2信号转导中的作用
NOSTRIN mediated eNOS trafficking=NOSTRIN介导eNOS转运
LDL remodeling=低密度脂蛋白重塑
Interleukin-1 signaling=白介素1信号转导
G alpha (q) signalling events=Gα(Q)信号转导事件
Synthesis of bile acids and bile salts via 7alpha-hydroxycholesterol=胆汁酸和盐经7α-羟基胆固醇合成
Xenobiotics=外源性物质
RUNX2 regulates osteoblast differentiation=RUNX2调节成骨细胞分化
Purinergic signaling in leishmaniasis infection=利什曼病感染中的嘌呤能信号
S Phase=S期
Signaling by ERBB2 KD Mutants=ERBB2 KD突变体的信号
PI5P, PP2A and IER3 Regulate PI3K/AKT Signaling=PI5P, PP2A和IER3调节PI3K/AKT信号
GRB7 events in ERBB2 signaling=ERBB2信号中的GRB7事件
Transcriptional Regulation by TP53=TP53的转录调控
Caspase activation via extrinsic apoptotic signalling pathway=通过外部凋亡信号通路激活Caspase
Constitutive Signaling by AKT1 E17K in Cancer=AKT1 - E17K在癌症中的本构信号
PTK6 Expression=PTK6表达
VLDL assembly=VLDL组装
Chylomicron clearance=乳糜微粒间隙
Integration of energy metabolism=能量代谢的整合
Cellular Senescence=细胞衰老
BMAL1:CLOCK,NPAS2 activates circadian gene expression=BMAL1:CLOCK,NPAS2激活昼夜节律基因表达
Syndecan interactions=Syndecan相互作用
MAP kinase activation=MAP激酶激活
Activation of NF-kappaB in B cells=NF-kappaB在B细胞中的活化
G1/S DNA Damage Checkpoints=G1/S DNA损伤检查点
CLEC7A/inflammasome pathway=CLEC7A/炎症体途径
PTK6 promotes HIF1A stabilization=PTK6促进HIF1A稳定
Replication of the SARS-CoV-1 genome=SARS-CoV-1基因组的复制
Replication of the SARS-CoV-2 genome=SARS-CoV-2基因组的复制
Activation of BH3-only proteins=bh3蛋白的激活
Downregulation of ERBB2 signaling=ERBB2信号下调
Trafficking of AMPA receptors=AMPA受体的转运
MAPK targets/ Nuclear events mediated by MAP kinases=MAPK靶/核事件由MAP激酶介导
Classical antibody-mediated complement activation=经典抗体介导的补体激活
Cell Cycle=细胞周期
Plasma lipoprotein remodeling=血浆脂蛋白重构
Glutathione conjugation=谷胱甘肽结合
Regulation of Insulin-like Growth Factor (IGF) transport and uptake by Insulin-like Growth Factor Binding Proteins (IGFBPs)=胰岛素样生长因子结合蛋白(IGFBPs)对胰岛素样生长因子(IGF)转运和吸收的调控
Platelet degranulation=血小板脱粒
ChREBP activates metabolic gene expression=ChREBP激活代谢基因表达
Thyroxine biosynthesis=甲状腺素生物合成
Synthesis of epoxy (EET) and dihydroxyeicosatrienoic acids (DHET)=环氧树脂(EET)和二羟二碳三烯酸(DHET)的合成
Interleukin-1 processing=白细胞介素1加工
RUNX3 regulates WNT signaling=RUNX3调节WNT信号
Biosynthesis of maresins=酚醛树脂的生物合成
Regulation of TNFR1 signaling=TNFR1信号的调控
Synthesis of (16-20)-hydroxyeicosatetraenoic acids (HETE)=(16-20)-羟乙二十烯酸(HETE)的合成
EGFR Transactivation by Gastrin=胃泌素激活EGFR
Adrenoceptors=肾上腺素能受体
NR1H2 & NR1H3 regulate gene expression to control bile acid homeostasis=NR1H2和NR1H3通过调控基因表达控制胆汁酸稳态
FCERI mediated NF-kB activation=FCERI介导的NF-kB激活
Cyclin E associated events during G1/S transition=G1/S转换过程中的细胞周期蛋白E相关事件
Transcriptional Regulation by VENTX=VENTX的转录调控
Cyclin A:Cdk2-associated events at S phase entry=Cyclin A: S期进入时cdk2相关事件
Neurotransmitter clearance=神经递质间隙
Acetylcholine regulates insulin secretion=乙酰胆碱调节胰岛素分泌
Caspase activation via Dependence Receptors in the absence of ligand=在配体缺失的情况下通过依赖受体激活半胱天冬酶
Activation of the AP-1 family of transcription factors=AP-1家族转录因子的激活
SUMOylation of immune response proteins=免疫反应蛋白的总甲基化
Ub-specific processing proteases=Ub-specific加工蛋白酶
Chylomicron assembly=乳糜微粒组装
HDL remodeling=高密度脂蛋白重构
Degradation of the extracellular matrix=细胞外基质的降解
Integrin cell surface interactions=整合素细胞表面相互作用
MAPK1/MAPK3 signaling=MAPK1 / MAPK3信号
Deubiquitination=去泛素化
Regulation of gene expression by Hypoxia-inducible Factor=缺氧诱导因子对基因表达的调控
eNOS activation=eNOS激活
TP53 Regulates Transcription of Cell Death Genes=TP53调节细胞死亡基因的转录
Signaling by Retinoic Acid=视黄酸信号
DNA Double-Strand Break Repair=DNA双链断裂修复
Downstream TCR signaling=下游细胞信号
GP1b-IX-V activation signalling=GP1b-IX-V激活信号
TP53 Regulates Transcription of Caspase Activators and Caspases=TP53调节Caspase激活子和Caspases的转录
TP53 Regulates Transcription of Death Receptors and Ligands=TP53调节死亡受体和配体的转录
Ethanol oxidation=乙醇氧化
NF-kB activation through FADD/RIP-1 pathway mediated by caspase-8 and -10=由caspase-8和-10介导的FADD/RIP-1通路激活NF-kB
Retinoid metabolism and transport=类维生素a代谢和运输
Interleukin-10 signaling=白细胞介素- 10 信号
Transcriptional regulation by RUNX3=RUNX3的转录调控
Infectious disease=传染性疾病
Downregulation of ERBB2:ERBB3 signaling=ERBB2下调:ERBB3信号
Depolymerisation of the Nuclear Lamina=核层的解聚
TNFR1-induced proapoptotic signaling=TNFR1诱导的促凋亡信号
Visual phototransduction=视觉光转导
ABC-family proteins mediated transport=abc家族蛋白介导转运
Ubiquitin Mediated Degradation of Phosphorylated Cdc25A=泛素介导磷酸化Cdc25A的降解
Ubiquitin-dependent degradation of Cyclin D=Cyclin D的泛素依赖性降解
Host cell nucleus=宿主细胞核
Cytoplasm=细胞质
Membrane-bounded organelle=膜结合细胞器
Endomembrane system=内膜系统
Protein-containing complex=含蛋白质复合物
Receptor complex=受体复合物
Integral component of plasma membrane=质膜的组成部分
Nuclear chromosome=核染色体
Organelle=细胞器
Plasma membrane region=质膜区域
Membrane raft=膜筏
Whole membrane=全膜
Postsynaptic membrane=突触后膜
Plasma membrane=质膜
Intracellular organelle=细胞内细胞器
Nuclear chromatin=核染色质
Chromatin=染色质
Intracellular organelle lumen=细胞内细胞器内腔
Cytosol=胞浆
Extracellular space=细胞外空间
Intracellular membrane-bounded organelle=细胞内面上细胞器
Chromosome=染色体
Neuron projection=神经元投射
Vesicle=囊泡
Nucleoplasm=核质
Integral component of synaptic membrane=突触膜的组成部分
Integral component of postsynaptic membrane=突触后膜的组成部分
Cell junction=细胞结
Intracellular=细胞内的
Cellular anatomical entity=细胞解剖实体
Synapse=突触
Cytoplasmic vesicle membrane=胞质囊泡膜
Somatodendritic compartment=躯体病支室
Plasma membrane protein complex=质膜蛋白复合物
Plasma membrane bounded cell projection=质膜有界细胞投影
Postsynapse=突触前部
Organelle membrane=细胞器膜
Mitochondrion=线粒体
Cell surface=细胞表面
Basal plasma membrane=基底质膜
Integral component of presynaptic membrane=突触前膜的完整组成部分
Membrane=膜
Axon terminus=轴突末端
Nuclear lumen=核内腔
Transcription regulator complex=转录调节因子复合物
Basolateral plasma membrane=基底外侧质膜
Cytoplasmic vesicle=胞质囊泡
Extracellular region=细胞外区域
External side of plasma membrane=质膜外侧
Vesicle lumen=囊泡腔
Perinuclear region of cytoplasm=细胞质的核周区
Apical part of cell=细胞的顶端部分
RNA polymerase II transcription regulator complex=RNA聚合酶II转录调节因子复合体
GABA-A receptor complex=乙酰丙酸受体复合物
Plasma lipoprotein particle=血浆脂蛋白颗粒
Plasma membrane signaling receptor complex=质膜信号受体复合物
Cell body=胞体
Secretory granule=分泌颗粒
Neuronal cell body=神经元胞体
Endocytic vesicle=内吞囊泡
ERBB3:ERBB2 complex=ERBB3: ERBB2复合物
Membrane protein complex=膜蛋白复合物
Nucleus=核
Endoplasmic reticulum=内质网
Dendrite membrane=树突膜
Extracellular exosome=细胞外泌体
Bounding membrane of organelle=细胞器的包围膜
Axon=轴突
Spindle=纺锤
Endocytic vesicle membrane=内吞囊泡膜
Glutamatergic synapse=谷氨酸能突触
Golgi apparatus=高尔基体
Dendrite=树突
Presynapse=突触前膜
Side of membrane=膜侧
Endoplasmic reticulum membrane=内质网膜
Platelet dense granule membrane=血小板致密颗粒膜
Intermediate-density lipoprotein particle=中等密度脂蛋白
High-density lipoprotein particle=高密度脂蛋白
Endoplasmic reticulum lumen=内质网腔
Distal axon=远端轴突
Clathrin-coated pit=被膜小窝
I-kappaB/NF-kappaB complex=I-kappaB/NF-kappaB 复合物
Secretory granule lumen=分泌颗粒内腔
GABA-ergic synapse=GABA-ergic突触
ficolin-1-rich granule lumen=ficolin-1-rich颗粒内腔
Postsynaptic specialization membrane=突触后特化膜
Glial cell projection=放射状胶质细胞
Integral component of postsynaptic specialization membrane=突触后特化膜的组成部分
Caveola=陷窝
Serine/threonine protein kinase complex=丝氨酸/苏氨酸蛋白激酶复合物
Mitochondrial outer membrane=线粒体外膜
Death-inducing signaling complex=死亡诱导信号复合物
Nuclear envelope lumen=核被膜内腔
Cholinergic synapse=胆碱能突触
Apical plasma membrane=顶端细胞质膜
Cyclin-dependent protein kinase holoenzyme complex=周期蛋白依赖性蛋白激酶全酶复合体
Organelle envelope=细胞器包膜
Fibrillar collagen trimer=纤维胶原三聚物
Nuclear lamina=核层
Platelet alpha granule=血小板α颗粒
Ion channel complex=离子通道复合物
Coated vesicle=涂层囊泡
Identical protein binding=相同的蛋白结合
Enzyme binding=酶结合
Protein binding=蛋白结合
Nuclear receptor activity=核受体的活动
Steroid binding=类固醇结合
Signaling receptor binding=信号受体结合
Binding=结合
Postsynaptic neurotransmitter receptor activity=突触后神经递质受体活性
Protein dimerization activity=蛋白质二聚体活性
Steroid hormone receptor activity=类固醇激素受体活性
Neurotransmitter receptor activity=神经递质受体活性
Molecular function regulator=分子功能调节子
RNA polymerase II transcription regulatory region sequence-specific DNA binding=RNA聚合酶II转录调节区序列特异性DNA结合
Cis-regulatory region sequence-specific dna binding=顺式调控区序列特异性dna结合
DNA-binding transcription factor binding=dna结合转录因子结合
RNA polymerase II cis-regulatory region sequence-specific DNA binding=RNA聚合酶II顺式调控区序列特异性DNA结合
Transcription factor binding=转录因子结合
Kinase binding=激酶结合
Signaling receptor activity=信号受体活性
DNA-binding transcription activator activity, RNA polymerase II-specific=dna结合转录激活子活性，RNA聚合酶ii特异性
Protein heterodimerization activity=蛋白质异二聚体活性
Double-stranded dna binding=双链dna结合
Protein kinase binding=蛋白激酶绑定
DNA-binding transcription factor activity, RNA polymerase II-specific=dna结合转录因子活性，RNA聚合酶ii特异性
Oxidoreductase activity=氧化还原酶活性
Protein-containing complex binding=含蛋白质的络合物结合
Ion binding=离子结合
Transition metal ion binding=过渡金属离子结合
RNA polymerase II-specific DNA-binding transcription factor binding=RNA聚合酶ii特异性dna结合转录因子结合
Cysteine-type endopeptidase activity involved in apoptotic process=半胱氨酸型内肽酶活性参与凋亡过程
Sequence-specific dna binding=序列特异性DNA结合
Organic cyclic compound binding=有机环化合物结合
Acetylcholine receptor activity=乙酰胆碱受体的活动
G protein-coupled acetylcholine receptor activity=G蛋白偶联乙酰胆碱受体活性
Hsp90 protein binding=HSP90蛋白结合
Cysteine-type endopeptidase activity involved in apoptotic signaling pathway=半胱氨酸型内肽酶活性参与凋亡信号通路
Lipid binding=脂质结合
Extracellular ligand-gated ion channel activity=细胞外配体门控离子通道活性
Catalytic activity=催化活性
G protein-coupled amine receptor activity=G蛋白偶联胺受体活性
Protein domain specific binding=蛋白质结构域特异性结合
Ubiquitin-like protein ligase binding=泛素样蛋白连接酶结合
Protein homodimerization activity=蛋白质均二聚体活性
Neurotransmitter receptor activity involved in regulation of postsynaptic membrane potential=神经递质受体活性参与突触后膜电位的调节
Transmitter-gated ion channel activity=发射器门控离子通道活性
Transcription regulator activity=转录调节活性
Monooxygenase activity=单加氧酶活性
Ubiquitin protein ligase binding=泛素蛋白连接酶结合
Peptide binding=肽结合
Cation binding=阳离子结合
Amide binding=酰胺结合
Transmembrane signaling receptor activity=跨膜信号受体活性
Zinc ion binding=锌离子结合
Lipid transfer activity=脂转移活性
Heterocyclic compound binding=杂环化合物结合
Nuclear hormone receptor binding=核激素受体结合
Oxidoreductase activity, acting on paired donors, with incorporation or reduction of molecular oxygen=作用于配对供体的氧化还原酶活性，分子氧的掺入或减少
Nuclear receptor binding=核受体结合
Estrogen receptor binding=雌激素受体结合
Small molecule binding=小分子结合
Cholesterol transfer activity=胆固醇转移活性
Core promoter sequence-specific dna binding=核心启动子序列特异性dna结合
Oxidoreductase activity, acting on paired donors, with incorporation or reduction of molecular oxygen, nad(p)h as one donor, and incorporation of one atom of oxygen=作用于配对供体的氧化还原酶活性，分子氧的掺入或还原，NAD(P)H为一个供体，一个氧原子的掺入
Enzyme regulator activity=酶调节活性
Chromatin binding=染色质结合
Activating transcription factor binding=激活转录因子结合
ATPase binding=ATPase结合
Transmitter-gated ion channel activity involved in regulation of postsynaptic membrane potential=递质门控离子通道活性参与突触后膜电位的调节
Estrogen 16-alpha-hydroxylase activity=雌激素16-α-羟基酶活性
Steroid hormone receptor binding=类固醇激素受体结合
Integrin binding=整合素结合
Potassium channel inhibitor activity=钾通道抑制剂活性
Oxidoreductase activity, acting on the aldehyde or oxo group of donors, nad or nadp as acceptor=氧化还原酶活性，作用于以NAD或NADP为受体的给体的醛或氧基团
G protein-coupled serotonin receptor activity=G蛋白偶联血清素受体活性
Glutathione binding=谷胱甘肽结合
Oxidoreductase activity, acting on nad(p)h, heme protein as acceptor=氧化还原酶活性，作用于nad(p)h，血红素蛋白为受体
GABA-gated chloride ion channel activity=gaba门控氯离子通道活性
Acetylcholine binding=乙酰胆碱结合
Repressing transcription factor binding=抑制转录因子结合
Antioxidant activity=抗氧化活性
Inhibitory extracellular ligand-gated ion channel activity=抑制细胞外配体门控离子通道活性
Oxidoreductase activity, acting on the ch-oh group of donors, nad or nadp as acceptor=氧化还原酶活性，作用于供体ch-oh基团，nad或nadp为受体
Peroxidase activity=过氧化物酶活性
Enzyme activator activity=酶激活剂活性
Channel inhibitor activity=通道抑制活性
Histone kinase activity=组蛋白激酶活性
Lipid transporter activity=脂质转运蛋白活性
Phospholipid transporter activity=磷脂转运蛋白活性
Heme binding=血红素结合
Transcription cofactor binding=转录辅因子绑定
RNA polymerase II general transcription initiation factor binding=RNA聚合酶II一般转录起始因子结合
Protease binding=蛋白酶结合
GABA-A receptor activity=GABA-A受体活性
Transporter activity=转运蛋白活性
Anion binding=阴离子结合
Cholesterol binding=胆固醇结合
Vitamin d 24-hydroxylase activity=维生素D24-羟基酶活性
E-box binding=E盒结合
DNA binding=DNA结合
Alcohol dehydrogenase (nadp+) activity=醇脱氢酶(NADP+)活性
Drug binding=药物结合
Protein kinase activity=蛋白激酶活性
Channel regulator activity=通道调节活性
Glutathione transferase activity=谷胱甘肽转移酶活性
Low-density lipoprotein particle receptor binding=低密度脂蛋白颗粒受体结合
Endopeptidase activity=肽链内切酶活性
Estrogen response element binding=雌激素反应元件结合
Cysteine-type endopeptidase activity involved in execution phase of apoptosis=参与细胞凋亡执行期的半胱氨酸型内肽酶活性
Phosphotransferase activity, alcohol group as acceptor=磷酸转移酶活性，醇基为受体
Potassium channel regulator activity=钾通道调节活性
Aromatase activity=芳香化酶活性
Kinase regulator activity=激酶调节活性
Scaffold protein binding=支架蛋白结合
Carboxylic acid binding=羧酸结合
RNA polymerase II core promoter sequence-specific DNA binding=RNA聚合酶II核心启动子序列特异性DNA结合
Phosphatidylinositol phospholipase c activity=磷脂酰肌醇磷脂酶c活性
Oxidoreductase activity, acting on nad(p)h=氧化还原酶活性，作用于NAD(P)h
Estrogen receptor activity=雌激素受体活性
ATPase-coupled lipid transmembrane transporter activity=atp酶偶联的脂质跨膜转运蛋白活性
ErbB-3 class receptor binding=ErbB-3类受体结合
Metal ion binding=金属离子结合
Phosphatidylcholine floppase activity=磷脂酰胆碱软脂酶活性
Estrogen 2-hydroxylase activity=雌激素2-羟基酶活性
Transcription coactivator binding=转录共活化子结合
Protein n-terminus binding=蛋白N末端结合
NADPH-hemoprotein reductase activity=NADPH-血红蛋白还原酶活性
Alpha-adrenergic receptor activity=α肾上腺素能受体活性
Histone deacetylase binding=组蛋白脱乙酰酶结合
Retinoic acid-responsive element binding=维甲酸响应元件结合
BH3 domain binding=BH3结构域结合
Lipoprotein particle binding=脂蛋白颗粒结合
p53 binding=P53结合
Kinase activity=激酶活性
NF-kappaB binding=核因子-kappaB结合
cytochrome-b5 reductase activity, acting on NAD(P)H=细胞色素b5还原酶活性，作用于NAD(P)
Histone threonine kinase activity=组蛋白苏氨酸激酶活性
Monocarboxylic acid binding=单羧酸结合
Peptide transmembrane transporter activity=多肽转运蛋白活性
Retinal dehydrogenase activity=视网膜脱氢酶活性
Patched binding=补丁结合
SMAD binding=SMAD结合
Protein kinase regulator activity=蛋白激酶调节活性
Transmembrane transporter activity=跨膜转运蛋白活性
Gated channel activity=门控通道活性
Oxygen binding=氧气结合
Sulfur compound binding=硫化合物结合
Aryl hydrocarbon receptor binding=芳基烃受体结合
Growth factor binding=生长因子结合
Prostaglandin receptor activity=前列腺素受体活性
